20 15
1 1 1 1 1 1 1 1 1 1 1 1 1 1 1 1 1 1 1 1
1 0 0 0 0 2 2 2 2 2 2 2 2 0 0 0 0 0 0 1
1 0 4 4 0 2 0 0 0 0 0 0 2 0 4 4 4 0 0 1
1 0 4 5 0 2 3 3 3 3 3 3 2 0 5 5 4 0 0 1
1 0 0 0 0 2 3 3 3 3 3 3 2 0 0 0 0 0 0 1
1 2 2 2 2 2 2 2 2 2 2 2 2 2 2 2 2 2 2 1
1 0 0 0 0 0 0 0 0 0 0 0 0 0 0 0 0 0 0 1
1 0 4 4 4 0 0 5 5 5 5 0 0 4 4 4 4 0 0 1
1 0 4 5 4 0 0 5 3 3 5 0 0 4 5 5 4 0 0 1
1 0 0 0 0 0 0 5 3 3 5 0 0 0 0 0 0 0 0 1
1 2 2 2 2 2 2 5 3 3 5 2 2 2 2 2 2 2 2 1
1 0 0 0 0 0 0 0 0 0 0 0 0 0 0 0 0 0 0 1
1 0 4 0 0 2 2 2 2 2 2 2 2 2 0 0 4 0 0 1
1 0 0 0 0 2 0 0 0 0 0 0 0 2 0 0 0 0 0 1
1 1 1 1 1 1 1 1 1 1 1 1 1 1 1 1 1 1 1 1
R 5 7 1 2
R 10 10 2 1
R 15 3 1 3
R 8 12 3 2
R 3 9 2 1
R 17 5 3 1
R 12 8 1 2
R 6 11 2 3