100 100
C C C C C C C C C C C C C C C C C C C D C C C C D C 2 C C C C C C 2 C C C C C C C C E C C C C C C D C C C C C C C C C C C 4 4 6 4 4 4 4 7 4 6 7 6 4 4 4 4 7 4 4 4 6 4 4 7 4 4 C C C C C C C C C C C C C
C D C C C C C C C C C C C C C C A C C C 2 2 C C C 2 C 2 C A A C E C C C C C C C D C C C C C C C C C C C C C C C C C 4 C C 4 4 6 4 4 4 4 4 4 4 4 4 6 6 4 4 4 6 4 4 4 4 4 4 4 4 6 4 C C C 4 C C C C C E C
C C C C C C C D C E C C C C C C A A C A A C C 2 A 2 C A A C C C C C A C 2 C C C C C C C C C C C C C C C C C C C C C C 6 7 4 4 4 4 4 4 4 7 4 4 6 6 4 6 4 6 7 6 4 4 4 4 4 7 4 4 6 4 4 C 4 C C C C C C C C
C C C C C C C D C C A C 2 2 A C A A A A 2 A 2 A A C A A A A A 2 2 2 C A A C C D C C C C C C C C C C C C C C C C C 4 4 4 4 4 4 4 6 7 6 6 4 7 6 4 4 4 4 4 4 4 4 4 4 4 4 4 4 4 6 4 4 4 4 C C 4 C C C C C C
C C C C C C C C C C C A A C A A A 2 0 1 2 0 3 2 0 3 0 0 1 0 0 A A C A A C C C C C C C C C C C C C C C C C C 4 C C C 4 4 4 4 6 4 4 6 4 7 4 4 4 4 6 7 4 7 4 4 4 6 6 4 7 4 6 4 6 7 4 4 4 4 C C C C C C C C
C C C C C C A C C C 2 A 2 2 2 C 0 3 1 0 0 2 0 0 2 3 3 0 1 1 0 2 0 C C 2 2 2 C A C C C C C C C C C C C C C C C C C 7 4 6 4 4 4 6 4 4 7 4 4 4 4 4 7 4 4 4 4 6 4 4 4 4 4 4 4 4 6 4 4 4 4 4 C C C C C C C C
E C C C C C A C 2 A 2 2 A 0 0 2 2 0 0 1 0 2 2 2 0 1 0 3 0 0 0 2 1 0 1 0 A C C C C C A C C C C D C C C C C C C C 6 4 4 4 4 4 4 4 4 4 4 7 6 7 4 4 4 4 6 6 6 4 4 4 6 4 4 4 4 4 7 4 4 4 4 4 4 C C C C C D C
C C C C C A C C C A A 3 0 2 2 2 2 0 0 0 0 0 0 0 0 3 0 2 2 0 0 2 0 0 0 0 2 C A A A 2 C C A C C C C C C C C C 4 6 4 4 4 4 4 6 4 6 6 4 6 6 4 7 4 7 4 4 4 4 4 4 4 4 4 6 4 4 4 6 6 4 4 4 4 6 4 4 C 4 C C C C
C C C C C C C A A C 0 3 0 2 0 1 1 2 0 1 3 2 3 0 0 0 2 0 1 0 0 3 0 0 0 0 0 0 2 A C C C A C C C C C C C C E C C 4 4 4 4 7 4 7 4 4 4 4 4 7 6 4 4 6 6 4 6 4 6 4 4 6 6 4 4 6 4 4 4 4 6 4 4 4 7 6 C C C C C C
C C C 2 2 2 A A 0 1 0 0 0 0 3 2 3 2 0 0 0 0 0 2 3 0 0 3 0 0 0 0 0 0 2 0 0 0 0 0 0 E A C C C C C C C C C C C 4 4 4 4 6 4 4 6 4 4 7 4 4 6 4 4 4 5 5 5 5 5 6 6 4 4 4 4 6 4 4 4 4 4 4 7 4 4 7 7 4 4 C C C C
C C C C A C C D 2 1 2 0 2 2 1 2 0 0 0 1 2 0 2 0 1 0 1 0 0 3 0 1 3 1 3 2 2 1 0 0 0 0 A A A A A C C C C C 4 C 4 4 4 6 7 4 4 4 4 4 4 4 4 4 4 4 5 6 6 6 6 5 6 5 5 5 4 6 4 4 4 4 4 4 4 7 4 4 4 4 4 C C C C C
C C C 2 C 2 0 0 0 2 2 2 0 0 0 1 1 0 0 0 0 3 0 3 0 3 2 0 0 0 3 2 0 2 0 3 3 0 0 0 1 2 0 C C 2 2 C C C C C C 4 4 7 4 4 4 4 4 4 4 4 7 4 4 5 5 4 5 5 5 4 5 5 5 5 6 5 5 4 4 6 4 4 4 4 4 4 4 4 4 7 6 C C C C C
C C 2 D 2 C 0 0 0 0 2 0 2 2 0 0 0 0 0 0 0 0 0 0 0 1 3 2 2 2 0 0 0 2 0 2 0 3 0 2 3 0 2 1 A C C C C C C C 4 4 4 4 4 4 6 4 7 4 6 4 4 4 6 4 5 5 5 5 6 5 4 5 4 5 5 5 5 4 4 4 4 6 4 4 6 6 4 4 4 4 4 4 C C C C
C C C A A 0 0 3 0 0 0 3 1 2 0 0 0 0 2 0 2 3 2 2 0 2 2 0 0 2 0 0 0 3 2 3 0 0 2 2 0 3 0 0 A A C C C C C C C 4 7 4 4 4 4 4 4 4 4 6 6 4 6 6 5 6 6 6 5 5 5 5 5 5 4 5 6 6 4 4 4 4 6 4 4 4 4 4 7 4 4 7 C 4 C C
C A 2 A 0 3 0 0 0 2 0 0 0 0 3 1 3 2 2 0 3 2 2 0 2 2 0 0 2 2 2 2 0 0 1 2 0 1 2 0 2 1 1 0 0 A C 2 A C C C C 4 4 4 4 4 4 4 4 4 4 4 4 4 5 5 6 6 6 6 6 5 6 4 5 6 5 4 6 5 6 5 4 4 4 4 4 4 4 4 4 6 4 4 C C C C
2 A 2 0 3 0 3 0 0 1 0 0 2 0 0 2 0 2 0 0 3 2 2 2 2 0 2 0 2 0 2 2 3 2 2 0 2 0 2 3 0 2 0 3 0 0 2 C A C A 4 4 4 4 6 4 4 4 4 4 6 4 4 7 6 4 5 6 6 6 6 6 5 4 6 4 5 5 5 5 5 6 5 4 6 4 6 4 6 6 6 4 6 6 4 4 C C C
2 2 2 0 0 0 0 2 0 0 2 1 2 2 0 3 2 2 0 3 2 2 2 2 2 0 2 3 0 2 2 2 2 2 2 2 2 0 2 0 0 0 2 0 0 2 A A C 2 C C C 4 4 4 6 4 4 4 7 4 4 4 7 6 6 5 6 6 6 6 6 5 5 5 5 5 5 4 5 6 5 4 4 4 4 4 4 4 4 4 6 4 4 6 C 4 C C
A A 1 0 2 0 1 0 2 0 0 0 0 0 2 0 0 2 0 0 2 2 2 2 3 0 3 2 3 2 2 1 1 1 2 3 2 0 0 0 2 0 0 1 2 1 0 2 C C C C C 4 4 4 7 4 6 4 6 6 7 4 4 5 4 5 5 6 6 6 5 5 6 5 6 5 6 6 4 5 5 6 6 6 6 4 4 4 4 6 4 4 4 7 C C C 4
A 2 1 2 2 3 0 1 0 2 2 0 0 0 0 3 2 2 2 2 2 0 0 0 2 2 2 2 2 0 2 1 1 1 2 3 2 0 0 0 2 0 0 0 2 1 0 A A 2 C C C 6 4 7 4 4 4 4 4 4 4 4 4 5 6 5 5 5 5 5 5 4 6 5 5 5 4 6 5 4 5 4 6 4 6 7 4 4 4 4 4 4 4 4 4 C C C
2 C 0 0 0 0 3 0 0 0 2 0 3 2 3 3 2 1 1 1 2 0 0 0 0 2 0 0 0 0 2 1 1 1 2 0 2 0 0 1 0 2 0 0 2 2 1 0 C A C C C 7 4 4 4 4 4 7 4 4 6 4 4 5 6 4 6 4 6 5 5 5 6 4 5 5 6 5 5 5 6 5 4 6 6 6 4 7 4 4 4 4 6 4 C C C C
A 3 2 2 0 2 1 2 0 3 0 2 0 2 0 0 2 1 1 1 2 1 2 1 2 1 1 2 2 0 2 2 2 2 2 0 2 3 1 0 0 0 0 0 0 0 3 0 C A 2 C C 7 4 4 7 6 6 7 7 4 4 6 7 6 6 6 5 5 5 5 5 5 5 4 5 5 5 6 6 6 5 5 4 4 4 4 4 4 4 4 6 4 4 6 4 C C C
A 0 3 0 2 0 0 0 0 0 0 2 0 2 2 3 2 1 1 1 2 1 1 1 2 2 1 2 1 2 2 2 2 0 3 2 2 2 0 0 0 2 0 0 2 3 3 0 A A A C C 4 4 6 4 4 4 7 4 6 4 4 4 5 5 5 6 4 4 A 5 5 5 5 6 5 6 6 6 6 6 5 6 4 4 4 4 4 4 4 4 4 4 4 C 4 C C
C 0 1 2 3 0 3 0 0 0 3 3 0 0 0 2 2 2 2 2 2 2 1 1 1 2 1 2 2 2 1 2 3 0 2 0 2 2 0 2 0 0 1 2 2 0 0 0 0 A A A C 6 4 4 4 4 4 4 4 4 7 6 4 5 5 5 4 4 A 4 6 6 5 4 4 5 6 6 6 6 6 5 7 4 4 4 4 4 4 4 4 4 4 6 C C C C
0 0 0 0 3 0 1 2 0 3 2 3 0 2 0 2 0 1 1 2 2 1 2 2 1 2 2 2 1 1 2 2 3 2 0 2 0 0 0 2 0 2 0 0 0 0 0 0 0 A C A C 4 6 7 4 4 4 4 6 4 6 4 6 4 6 4 A 4 4 A 5 6 6 6 5 5 6 6 6 6 6 5 4 4 4 4 4 6 4 4 7 4 4 4 C C C C
3 3 1 0 1 0 2 0 0 2 0 2 2 2 2 2 2 2 2 2 1 2 2 2 1 1 1 1 2 1 2 1 1 3 2 2 2 0 2 2 0 0 0 0 0 0 0 0 2 2 C A C 4 4 4 6 7 4 4 6 4 4 7 4 4 4 A A A 4 5 6 6 6 6 6 5 5 6 6 6 5 6 4 6 4 4 4 6 4 4 4 4 4 6 C C C C
3 1 2 2 1 0 0 3 0 2 0 2 3 0 3 2 2 1 1 1 1 1 1 1 1 1 1 2 2 1 2 1 1 2 0 0 0 0 3 2 2 0 0 2 3 0 2 0 1 2 A 2 C C 4 4 6 6 4 4 4 4 6 4 4 4 A A 4 4 5 4 5 4 4 6 5 4 4 5 5 5 4 4 4 4 4 6 7 4 7 4 6 7 4 C C C C C
3 0 2 3 1 0 0 0 1 3 2 2 2 2 0 2 1 1 1 2 2 2 2 1 1 1 1 2 1 1 1 1 2 3 2 3 0 2 0 3 0 3 0 0 0 0 0 0 3 2 A C C 4 4 4 4 4 6 7 4 4 4 4 6 4 4 A 4 6 5 6 5 5 5 5 5 5 4 5 4 4 7 4 6 6 4 4 4 4 4 4 4 4 4 4 C 4 C C
2 0 1 0 0 0 0 1 2 2 2 0 2 0 2 2 1 2 2 2 2 2 1 2 1 A A A 2 1 1 1 1 0 0 2 0 3 3 0 2 0 0 0 3 1 0 2 0 2 2 C C C 4 4 6 4 6 4 4 4 4 4 4 4 4 5 5 5 5 6 6 5 5 5 5 6 5 6 4 6 4 6 4 4 6 4 4 4 4 4 4 4 4 4 D C C C
0 0 0 0 0 0 0 0 0 0 0 0 3 2 3 2 2 2 1 1 2 2 2 2 1 A A A A 2 2 1 2 0 2 0 0 0 2 0 2 3 0 0 1 0 2 0 0 A C A C 4 C 7 7 4 4 4 4 4 4 4 4 A 5 6 6 6 5 4 4 6 4 4 7 4 4 6 7 4 4 4 4 4 4 6 4 6 4 4 4 4 4 C C C C C
0 2 2 2 0 1 2 2 0 2 2 0 3 0 0 2 2 1 2 1 1 2 1 1 2 A A A A A 1 2 2 3 3 2 2 2 0 2 0 0 0 0 0 0 0 0 1 A A 2 C C 4 4 4 4 4 4 4 6 4 4 A 5 6 6 6 6 6 5 4 6 7 4 4 7 7 6 4 4 4 4 7 4 4 4 4 6 4 4 4 4 C C C C D C
2 0 0 0 0 0 0 0 1 0 2 0 0 2 0 2 2 2 1 2 1 1 1 1 2 1 A A A A A 1 1 0 0 2 2 0 0 2 2 0 0 0 3 0 0 2 0 2 C C C A C C 4 6 7 6 4 4 A 4 A 5 6 6 6 6 6 5 4 4 4 4 4 4 6 4 4 4 6 6 4 7 4 4 4 6 7 7 4 C C C C C C C
0 0 0 0 0 1 0 0 3 0 2 0 2 2 2 0 2 1 1 2 1 1 2 2 1 1 1 A A A A A 1 0 0 0 0 0 3 2 0 0 0 0 0 0 3 0 0 A A C A C C C C 4 4 4 4 4 4 4 A 5 6 6 6 6 6 5 4 4 4 4 4 7 6 4 4 7 4 4 7 4 7 4 4 7 4 6 C C C C C C C C
0 2 1 2 0 0 3 0 0 0 2 2 2 0 2 0 1 1 1 1 1 1 2 1 1 1 1 1 A A A A A 0 0 2 3 2 3 3 0 2 0 2 0 0 2 0 0 A A C C C C 4 C C 4 7 4 4 4 4 6 6 5 6 6 6 5 4 6 4 4 4 4 6 6 4 4 4 4 6 4 4 4 6 6 7 4 C 4 C C C C C C C
C 0 0 1 2 2 0 2 0 0 0 0 2 0 3 0 2 1 1 1 2 1 1 1 1 1 2 1 1 A A A A A 0 0 2 2 0 0 0 0 1 0 0 2 1 2 0 A C A A C C C D C 4 4 4 4 4 4 4 4 4 5 5 5 4 4 7 6 4 7 4 4 7 4 4 4 4 7 4 4 4 4 6 4 4 4 C 4 C C C C E C
0 3 0 0 0 0 0 1 3 2 2 3 3 2 0 0 0 0 2 2 2 2 2 1 2 1 1 1 1 2 A A A A 2 0 2 0 0 2 0 1 0 0 0 0 1 3 0 A A 2 A C C C C 4 4 4 A 4 A 4 7 4 4 4 6 4 6 7 4 4 4 4 4 4 4 4 4 4 4 4 6 7 6 7 4 6 C C C C C C C E C C
A 0 3 2 0 1 1 0 0 3 2 0 0 0 3 0 2 2 2 1 1 1 2 2 1 1 2 2 1 2 2 A A A A 0 2 2 3 3 0 2 1 0 0 0 3 1 A D C A C C C C C 4 4 4 A 4 6 4 4 4 4 4 4 4 4 4 4 6 4 4 6 4 6 4 4 6 4 4 4 4 4 4 C C 4 C C C C C C C C C
2 0 0 3 2 3 2 0 3 0 0 0 2 0 0 2 2 2 2 1 1 1 2 1 2 1 2 2 2 3 2 A A A A A 2 0 0 0 0 0 0 0 0 0 0 0 A 2 A C E C C C 4 4 4 A 4 C 4 4 4 4 4 4 6 4 4 4 4 6 4 4 4 6 4 4 4 7 4 7 6 4 4 4 C C 4 C C C C C C C C C
C 2 2 0 2 0 0 2 0 0 0 3 2 2 0 2 2 0 2 1 1 1 2 2 2 3 3 3 2 2 2 2 A A A A A 2 1 0 0 0 2 1 2 0 2 0 C C A C C C C C A 4 4 A C C C 4 4 4 4 4 4 4 4 7 6 4 4 7 4 6 4 4 4 6 4 4 4 6 C C 4 4 C C C C C C C C C C
A A 0 0 1 0 2 0 1 2 0 0 3 0 0 2 2 2 2 2 2 2 2 0 0 2 0 2 0 2 2 2 2 A A A A A 0 2 2 0 0 1 3 0 0 A A C C C C C C 4 A 4 4 C 4 C C 4 4 4 6 7 4 6 4 4 4 4 4 4 4 7 6 4 4 4 4 4 C 4 4 C C C C C C C C C C C C C
A 2 3 2 0 0 3 0 0 0 3 0 0 2 2 2 0 2 0 0 2 2 3 0 2 2 0 2 0 0 0 2 2 0 A A A A 2 0 0 2 0 3 0 0 2 2 2 D C C C C 4 4 4 A 4 C A C C C C C C C 7 4 4 4 6 6 4 4 4 4 4 4 4 C C C C C C C C C C C C C C C C C C C
C C A 0 0 2 2 0 2 0 2 1 0 3 0 2 2 3 2 0 2 2 0 2 2 0 0 0 3 0 3 2 2 0 2 A A A A 0 0 0 0 1 0 0 2 A A A 2 C C 4 A F F F F F F F C C C C C C C C C C C 4 4 4 C C C C 4 C C C C C C C C C C E C C C C C C C C
C C C 0 3 0 0 0 0 0 0 1 3 2 1 3 2 0 0 2 3 0 3 2 0 2 0 2 3 2 0 2 3 2 0 A A A A A 0 2 0 0 0 C 2 A 2 C C C C A 4 F C C C C C F C D C C C C 4 C C C C C C 4 C C 4 C C 4 C C C C C C C C C C C C C C C C C C
C C 2 A 2 0 1 0 0 3 1 2 0 3 0 0 3 3 2 3 2 3 2 2 3 0 0 2 0 0 0 2 0 2 1 0 A A A A A 0 0 0 3 2 C C A C C C C A A F C C C C C F A C C C C C C C C C C C C C C C C C C C C C C C C C C C C C C C C C C C C C
C C A C 2 0 2 0 0 3 0 3 2 0 3 0 0 0 0 0 2 0 2 2 2 2 0 2 2 2 2 2 2 0 3 0 3 A A A A 0 2 0 A 2 A A 2 C C C 4 4 A F C C C C C F A C C C C C C C C C C C E 4 C C C C C C C C C C C C C C C C C C C C C C C C
C C 2 C A C 2 0 0 0 0 0 2 1 2 2 2 2 0 0 0 3 0 2 0 0 0 2 0 0 3 2 3 1 0 2 0 0 A A A A 0 0 A 2 A C C C C A 4 A 4 F C C C C C F C C C C C C C C C C C C C C C C C C C C D C C C C C C C C C C C C C C C C C
C C C A A 2 C 2 0 2 2 0 2 1 0 0 1 0 1 3 1 3 0 0 0 0 0 0 3 3 2 0 0 0 0 3 0 0 A A A A A A A C A A A A C 4 A 4 A F F F F F F F A C C C C C C C C C C C C C C C C C C C C C C C D C C C C D C C C C C C C C
C C C D 2 C 2 2 3 1 0 0 0 0 0 0 0 0 2 0 0 0 2 1 0 2 0 0 0 2 0 0 0 0 0 3 0 0 2 A A A A A F F F F F F C 4 A A C C C A A A C A C C C C C C C C C C C C C C C C C C C C C C C C C C C C C C C C C C C C E C
C C 2 A C C C 2 0 0 0 0 1 0 1 0 2 0 0 0 2 0 0 0 0 0 0 0 0 2 2 3 0 3 2 2 0 0 2 1 A A A A F C C C C F 4 4 A A C C C A A A C C C C C C C C C C C C C C C C C C C C C C C C C C C C C C C C C C C C C C C E
C D C C C C C C A A 0 1 0 0 2 0 0 1 3 0 1 0 2 2 0 2 0 1 0 2 0 0 2 2 0 2 1 2 2 2 2 C A A F C C C C F A 4 4 4 C D A A A A C C C C A A A C C D C C C C C C C C C C C C C C C C C C C C C C C C C C C C C C
C C C C C C C C E C A 2 0 0 0 2 0 0 0 0 1 3 0 0 0 2 2 0 0 0 1 2 0 3 0 3 0 0 A C A A C C F C C C C F 8 A 4 C C A C C C C C C C C A A C A A C C C C C C C C C E C D C C C C C E C C C C C C C C C C C C C
C D C C C E C C 2 A C C 2 1 0 0 3 2 0 0 1 0 2 0 1 3 2 1 0 2 2 0 0 0 0 0 2 A C 2 C C C C F F F F F F 8 8 8 A A A A A A C C C C A C A A C C C C A C C C C C C C C C C C C C C C C D C C C C C C C C C C C
C C C C C C C C A C 2 C 2 C 2 2 0 0 3 0 2 0 0 0 1 0 0 0 0 2 2 2 0 0 A 2 2 2 2 E E E C C A C A A A A 8 A 8 C C C C E E E C C A C A C A C A C C A A C A A C C C C C C C E C C C C C D C C C C C C C C C C
C C C C C C C C C C A A A C A A A 2 0 2 1 0 0 0 0 0 2 0 0 0 0 2 A C 2 C C C C E E E C C C C A A A C 8 A A A C A 8 E E E A 8 9 A A 8 A 9 8 C C C A C C C C C C C C C C C C C C C C C C C C C C C C C C C
C C C C C D C C C C C C C C C 2 2 A A 2 A 2 2 A A 2 A A A A 2 A 2 C C 2 2 C C E E E C C C C A A A C 8 A A A 9 9 A E E E 9 A A A B 8 9 8 B A A 9 A C C C C A C A C C C C C C C C C C C C C C E C C C C C
C C C C C D C C C C C C C C C C 2 A C C C C A 2 A A 2 2 2 C D C C D C C C A C E C C C C C C C C C C A A 8 8 8 9 A 8 8 8 A A A A B A 8 A A 8 B 8 8 A C A C C C C C C C C C C C C C C C E C C C C C C C C
C C C C C C C C C C C C C C A C C 2 C C D C 2 C C 2 C C A 2 C A C C C C C C C C C C C C C A C A A C 8 A A 8 8 8 9 A 8 B A 8 A A A B A A 8 A A B A A 9 A C C C C C C C C D C C C C C C C C C C E C C C C
C C C C C C C C C C C C C C C C C 2 C C C A C 2 C C C 2 C A C C C A C C C C C C C C A C C C C C 9 8 B 8 8 8 A 8 A 9 B 8 9 9 A 8 9 9 8 A 8 9 A B A 8 A A 8 A A C C A C C C C C C C C C C C E C C C C C C
C C C C C C C C C D C C C C C C C C C C C C C C C C C C C C C C C C C C C E C C C C A C C A A 8 A A 8 8 A A 8 8 8 8 8 B 8 A A B 9 9 9 A B 9 A B 9 B A 9 8 A A C C A C C C C C C C C C C C C C C C C C C
C C C C C C C C C C C C C C C E C C C C C C C C C C C C C C C E C C C C C C C C C C C A A C A 8 A 9 8 A B A 8 A 8 8 8 9 9 A B A 9 A 8 8 A 9 A 9 8 9 A A A 9 9 A C C C C C C C C C C C C C C C C C D C C
C C C C E C C C C C C C C E C C C C C C C C C C E C C C C C C A C C A A C C C C C C C A C 8 9 E E E 8 8 A A A 8 A A 9 A 8 9 8 A A 9 9 9 8 A 9 A 9 8 A 8 A B 8 A C C A C C C C C C C C C C C C C C C C C
C C C C C C C C C C C C C C C C C C C C C C C C C C C C C C F F F F F C C C C C C A C C 8 B B E E E A 8 A 8 A 8 8 8 A A A 8 8 8 8 A 9 A B 8 9 A 9 A B 9 9 A A 8 9 A A A C C C C C C C C C C C C C C C C
C C C C C C C C C D C C C C C C C C C C C C C C D C C C C A F C C C F C C C C C C A A A 8 9 B E E E 8 8 A 8 B 8 A 8 8 A 9 A 8 8 A A 9 A 8 A A 8 8 A A A 9 B A A A C C C C C C C C C C C C C C C C C C C
C C C C C C C C C C C C C C C C C C C C C C C C C C C C C C F C C C F C C C C C C C A 8 A A A 8 8 9 B 9 A A B A 8 A 8 A A 8 9 A A A B 8 8 8 9 9 8 9 8 A B A B B A A A C D C C C C C C C C C C C C C C C
C C C C C C C C C C C C C C C C C C C D C C C C C C C C C A F F F F F C C C A C A C B B 8 8 B A 8 B A A 8 A B A A 8 A A 8 B A 9 B A 9 A 9 A A 9 A A B 9 A A A 8 A 9 8 C C C C C C C C C E C C C C C C C
C C C C C C C C C C C C C C C C C C C C C C C C C C C C C C C A A A A A C C C C C C A 8 A A B A 9 8 9 8 8 A A 8 9 8 8 8 9 9 9 9 9 8 9 A 8 A 8 B A B 9 A A 8 A 9 8 A 9 A C C C C C C C C C C C C C C C C
C C C E C C C C C E C C C C C C C C C C C C C C C C C C C C C A A A D C C C C C C 8 A B 8 8 9 A A 8 A 8 B 9 B 9 9 A 8 A 8 9 B 9 8 8 9 9 B A 9 A 9 B 9 A 8 B A B B 8 A B C A C C A C C C C C C C C C C C
C C C C C C C C C C C C C C C D C C C C C C C C C C C C C C C A A A C C C C C C A A 8 8 9 8 A B 8 9 9 A 9 8 9 9 8 9 A 8 8 8 B 9 B 9 8 9 B 9 9 A 8 A B A 9 8 A A A 9 B 8 A A A C A C C C C C C D C C C E
C C C C C C C C C C C C C C C C C C C C C C C C C C C C D C C C C C C C C C C C C A 9 8 A B 8 8 B A 8 A 8 9 B B B 8 8 8 8 8 8 8 9 9 9 9 9 8 9 A 8 8 8 A B 8 B B 9 8 B A C A C C C C C C C C C C C C C C
C C C C C C C C D D C C C C C C C C C C C C C C C C C C C C C C C C C C C A D C 8 A 8 A A B A B 9 B 8 8 8 9 B B B 8 8 8 A 8 9 8 8 8 8 B 9 8 9 9 B B 9 8 8 9 A A A 9 8 9 A C A C C C C C C C C C C C E C
C C C C C C C C C C C C C C C C C C C C C C C C C C D C C C C C C C C C E C A A A A A B B A 9 A A 8 A A A 9 B B B 8 8 8 A A B 9 9 8 B 8 B 8 B 9 9 8 9 B B B 8 8 A 9 8 A B C A C C C C E C C C C C C C C
C C C C C C C C C C C C E C C C C C C C C C C C C C C C C C C C C C C A C C A C 8 8 B 9 A A A B A A A 9 8 8 8 8 9 8 9 A A 8 8 9 8 8 8 B 9 B 9 8 B A A A A 9 A 8 9 9 A A A C C A A C C C C C C C C C C C
C C C C C C C C C C C C C C C C C C C C C C C C C C C C E C C C C C C C A C A C 9 9 8 B 9 8 A A 9 B B A 8 9 B 9 8 B 9 8 A 8 9 9 9 9 8 B B 8 9 B 8 9 A B 9 A 9 A B B A 8 B A C C C C C C C C C C C C C C
C C C C C C C C C C C C C C C C C D C C C C C C C C C C C C C C C C C C C C C C A 9 B A 8 9 8 B 8 9 B A 9 B 9 9 B 8 8 B 9 9 9 9 B 8 8 9 9 B 8 9 B A A B 8 9 B A 9 A 8 8 A C C A D C C C C C C C C C C C
C C C C C C C C C C C C C C C C C C C C C C C C C C C C C C C C C C D C E A C C 8 A 9 9 8 8 A 9 8 B 8 8 9 8 9 9 9 B B 9 9 8 8 B 9 8 9 9 9 8 8 B 9 9 B B 9 A 8 8 A 8 B B B A C C C C C C C C C C C C C C
C C C C C C C C C C C C C C C C C C C C C C C C D C C C C C C C C C C C C A A C 8 B 8 8 A A 8 A A A B 8 9 9 9 9 B 9 9 8 8 9 9 9 B 9 9 8 B 8 9 9 9 B B B A A 9 8 8 A A A A C C C C C C C C C C C C C C C
D C C C C C C C C C D C C C C C C C C C C C C C C C C C C C C C C E C C C C C A 8 9 A A A 8 9 A 9 8 9 8 8 8 B 9 B 9 9 9 9 8 8 8 B 8 9 9 9 9 8 B B B B A A A B B 9 9 A 9 A C C C C C C C C C C C C E C C
C C C C C C C C C C C C C C C C C C D C C E C C C C D C C C C C E C C C C C C C 8 A 9 A 8 9 A A 8 9 9 9 B 9 8 9 B 9 9 9 8 9 8 9 9 9 9 B 8 9 8 8 B 8 A 8 8 9 A 9 8 8 9 A B A C C C C E C C C C C C C C C
C D C C C C C C C D C C C C D C C C C C C C C C D C C C C C C C C C C C C A A A A B A 8 9 A 9 8 9 A 8 B B 9 8 8 8 9 9 B B B 8 8 B 8 8 9 B 8 9 B 8 8 8 9 9 A A 8 A 8 9 B A C C A C C C C C C C C C C C C
C C C C C C C E C C C C C C C C C C C C C C C C C C C C C C C C D C C C C C C C A A A 9 A A 9 A 9 B 8 A B B 9 B 8 8 9 B B B 8 B 9 B 9 9 9 9 9 9 8 9 A A A A 8 A 8 A A A A C A C A C C C C C C C C C C C
C D C C C C C C C C C C C E C C C C C C C C C C C C C C C C C C C C C C C C C C 8 9 A A A 8 A 8 A A 9 B 9 9 9 9 8 8 9 B B B 9 8 8 B 9 B 8 B B B 8 B 8 B B B A 8 B A B A 9 C C A C C C C C C C C E C C C
C C C C C C C C C C D C C C C C C C C C C C C C C C E C C C C C C C C C C C C C B A 9 9 A 8 A B A B A 9 A 9 8 9 9 9 9 9 8 8 8 9 9 9 B 9 9 B B B 8 B A 9 A 8 9 9 8 8 8 A A C A C A C C C C C C C C C C C
C C C C C C C C C C C C C C C C C C C C C C C C C C C C C C C C C C C C C C C A C A A A A A 8 B B A A 8 B A 8 8 9 8 9 8 9 9 8 8 B 9 8 8 9 B B B 8 B A A B A 9 8 9 A B A A A A C C C C C C C C C C C C C
C C C C C C C C C C C D C C C C C C C C C C C C C C C C C C C C C C C C C C A C C 8 A 9 B 8 8 9 A 8 A B A A 9 9 B 8 8 9 9 9 8 B 9 9 9 9 8 9 9 8 9 B A A A A A 9 8 8 9 9 C C A C D C C C C C C C C C C C
C C C C C C C C C C C C C C C C C C C C C C C C C C C C C C C C C C C C C C C C C A 9 A A 9 8 A 9 B 8 8 A A A 9 9 9 9 9 9 9 9 8 9 9 B B 9 8 A A B B B 9 A A A A A A 8 9 A C C C C C D C C C C C C C C C
C C C C C C E C C C C C C C C C C C C C C C C C C C C C C C C C C C C C E C E C C C 9 B A 8 A 9 A B A 8 A B A 8 8 B 9 8 8 8 B B 9 9 9 8 8 B A A 9 A A 9 B A 8 8 A 8 A A A C C C C C C C C C C C C C C C
E E C C C C C C C C C C C C C C C C C C D C C C C C C C C C C C C C D C C C A C C A 9 A 8 B A 8 9 A 8 8 9 A 8 9 A A B 8 8 9 8 9 A 9 9 9 9 A A B A 9 9 B B 8 9 8 B B A C A C C C C C C C C C C C C D C C
C C C C C C C C C C E C C C C C C C C C C C C C C C C C C C C C C C C D C C C A C C A 8 A A 9 A A 9 8 A A A A A 9 B A A 9 B A B A A A 8 A A B A A 9 A B B 8 A A A A A C C C A C C C C C C C C C C C C C
E C C C C C C C C C C C C C C C C C C C C C C C C C C C E C C C C C C C C C C C C C A C A B A A 9 9 8 A A A B B 9 9 B 9 9 8 9 A 9 A A B B B A A 8 A 8 A A A B A 8 A C C C C C C C C C C C C C C C C C C
C C C C C C C C C C C C C C C C C C C C C C C C C C C C C C C C C D C E C C C C C C C C A A B A 9 A A 8 9 8 A A 8 8 A B A 8 B A 8 9 9 A B A A A 9 8 9 B A 8 8 A A C A A C C C C C C C C C C C C C C C C
C C C C C C C C C C C C C C C C C C C C C C C E C C C C D C C C C C C C C C C C A C A C A 8 A 8 A 8 A 9 B 8 8 8 9 9 8 9 9 A 9 8 B A A A A A A A A 8 8 A 9 8 A B C C C C C C C C C C C C C C C C C C C C
C C C C C C E C C C C C C C C C C C C C C C C C C C D C C C C C C C C C C C C C C C C A A C A A 8 8 A 8 B A 9 8 A A 9 A 9 A 9 A A B 9 8 A 8 B 8 8 9 B B 9 A A C C C C C C C C C C C C C C E C C C C C C
D C C C C C C C C C C C C C C C C C C C C C C C C C C C C E C C C C C C C C C C C C C C C A C 8 A A A 9 A B 8 8 A B 8 B 8 A A A 9 A A 8 A 8 A 8 B 8 8 A A 9 C A C C C C C C C C C C C C C C C C C E C C
C C C C C C C C C C C C C C C C C C C C C C C C C E C C C C C C E C C C C C C C C C C C A A C C A 8 B 8 8 A A 8 8 A A B A 8 A A A 8 A 8 B A 8 B 9 B A B 9 C A C C C C C C C C C C C C C C C C C C C C C
C C C D C E C C C C C C C D D C D C C C C C C C C C E C C C C C C C C C C C C C C C C C C C C C C A 8 9 B A 8 A 8 9 8 B B A A A 9 8 A 8 9 A A 8 A 9 8 C C C C A C C C C C C C C C C C C C C C C C C C C
C C D C C C C D C D C C C C C C C C C C C C C C C C C C C C C C C C C C C C C C C C C C C C C C A C C A A A A 8 8 8 9 8 B A 9 9 B 8 A A A B A 9 A 9 A C A D A A A C C C C C C C C D C C C C C C C C C C
C C C C C C C C C C C C C D C C C C C C C C E C C C E C C C C C C C E C C C C C C C C C C C C C C C C A C A A A 8 A 9 A A 8 A 8 A B 9 A 9 B A A C C C C A C C C C C C C C C C C C C C C C C C C D C C C
C C C C C C C C E C C C C C C C C C C C C C C C C C C C C C C C C E C C C C C C C C C C D C C C C C A A C C C C 8 A B B A A 8 A B B A 9 B A A A A C A C C C C C C C C C C C C C C D C C C C C C C C C E
C E C C C C C C C C C C C C C C C C C C C C C C C C C C C D C C C C C C C C C C C C C C C C C A C C C C C C C A C A C C C C A C A C C C A C C A C C C C A C C C C C C C C C C C C C C C E C C C C C C C
C C C C C C C C C C C C C C C C C C C C C C C C C C C C C C C C C C C C C C C C C C C C C C C C C C C C C C C A C A A C C C A C A A C A A A C A D C C C C C C C C C C C D C C C C C C C C C C C C C C C
D C C C C C C C C C C C C C C C C C E C C C D C C C C C C C C C C C C C C D C C C C C C C C C C C C C C C C C A C A C C C C C C E A A C C C C C C C C C C C C C C C C C C C C C C C C C C C C C C C C C
