100 100
2 2 2 2 2 2 2 2 2 2 2 2 2 2 2 2 2 2 2 2 2 2 2 2 2 2 2 2 2 2 2 2 2 2 2 2 2 2 2 2 2 2 2 2 2 2 2 2 2 2 2 2 2 2 2 2 2 2 2 2 2 2 2 2 2 2 2 2 2 2 2 2 2 2 2 2 2 2 2 2 2 2 2 2 2 2 2 2 2 2 2 2 2 2 2 2 2 2 2 2
2 5 5 5 5 6 5 5 5 5 7 5 5 5 5 5 5 5 5 5 5 7 6 5 5 5 5 5 5 5 5 5 7 5 5 5 5 5 5 6 5 5 5 7 5 5 0 0 0 0 0 0 0 0 4 8 4 4 4 4 4 4 4 4 4 4 4 4 4 9 4 4 4 4 8 4 4 4 4 4 4 4 4 4 4 4 4 4 4 4 4 4 9 8 4 4 4 4 4 2
2 5 5 5 5 5 5 5 5 7 6 5 5 5 5 5 5 5 5 5 7 5 5 5 5 5 5 6 5 5 5 7 5 5 5 5 5 5 5 5 5 5 7 5 6 5 0 0 0 0 0 0 0 0 4 4 4 4 4 4 4 4 4 4 4 4 4 4 4 9 4 4 8 4 4 4 4 4 4 4 4 4 4 4 4 4 4 4 4 4 4 8 9 4 4 4 4 4 4 2
2 5 5 5 5 5 5 5 7 5 5 5 5 5 5 6 5 5 5 7 5 5 5 5 5 5 5 5 5 5 7 5 6 5 5 5 5 5 5 5 5 7 5 5 5 5 0 0 0 0 0 0 0 0 4 4 4 4 4 4 4 4 4 4 4 4 4 4 4 9 8 4 4 4 4 4 4 4 4 4 4 4 4 4 4 4 4 4 4 8 4 4 9 4 4 4 4 4 4 2
2 5 5 6 5 5 5 7 5 5 5 5 5 5 5 5 5 5 7 5 6 5 5 5 5 5 5 5 5 7 5 5 5 5 5 5 5 6 5 5 7 5 5 5 5 5 0 0 0 0 0 0 0 0 4 4 4 4 4 4 4 4 4 4 4 4 4 4 8 9 4 4 4 4 4 4 4 4 4 4 4 4 4 4 4 4 4 8 4 4 4 4 9 4 4 4 4 4 4 2
2 5 5 5 5 5 7 5 6 5 5 5 5 5 5 5 5 7 5 5 5 5 5 5 5 6 5 5 7 5 5 5 5 5 5 5 5 5 5 7 5 5 6 5 5 5 0 0 0 0 0 0 0 0 4 4 4 4 4 4 4 4 4 4 4 4 8 4 4 9 4 4 4 4 4 4 4 4 4 4 4 4 4 4 4 8 4 4 4 4 4 4 9 4 4 4 4 4 4 2
2 5 5 5 5 7 5 5 5 5 5 5 5 6 5 5 7 5 5 5 5 5 5 5 5 5 5 7 5 5 6 5 5 5 5 5 5 5 7 5 5 5 5 5 5 5 0 0 0 0 0 0 0 0 4 4 4 4 4 4 4 4 4 4 8 4 4 4 4 9 4 4 4 4 4 4 4 4 4 4 4 4 4 8 4 4 4 4 4 4 4 4 9 4 4 4 4 4 4 2
2 6 5 5 7 5 5 5 5 5 5 5 5 5 5 7 5 5 6 6 6 6 6 6 6 6 7 6 6 6 5 5 5 5 5 6 5 7 5 5 5 5 5 5 5 5 0 0 0 0 0 0 0 0 4 4 4 4 4 4 4 4 8 4 4 4 4 4 4 9 8 8 8 8 8 8 8 8 8 8 4 8 4 4 4 4 4 4 4 4 4 4 9 4 4 4 4 4 4 2
2 5 5 7 5 5 6 5 5 5 5 5 5 5 7 5 6 6 6 6 6 6 6 6 6 7 6 6 6 6 6 6 6 5 5 5 7 5 5 5 6 5 5 5 5 5 0 0 0 0 0 0 0 0 1 4 4 4 4 4 8 4 1 4 4 4 1 8 8 9 4 8 8 8 1 8 8 8 1 8 8 8 4 4 4 4 1 4 4 4 1 4 9 4 4 4 4 4 8 2
2 5 7 5 5 5 5 5 5 5 5 6 5 7 5 6 6 6 6 6 6 6 6 6 7 6 6 6 6 6 6 6 6 6 5 7 5 5 5 5 5 5 5 5 5 6 0 0 0 0 0 0 0 0 4 4 4 4 8 4 4 4 4 4 4 8 8 8 8 9 8 8 8 8 8 8 8 8 8 8 8 8 8 8 4 4 4 4 4 4 4 4 9 4 4 4 8 4 4 2
2 7 5 5 5 5 5 5 5 5 5 5 7 6 6 6 6 6 6 6 6 6 6 7 6 6 6 6 6 6 6 6 6 6 7 6 5 5 5 5 5 5 5 5 5 7 0 0 0 0 0 0 0 0 4 4 8 4 4 4 4 4 4 8 8 8 8 8 8 9 8 8 8 8 8 8 8 8 8 8 8 8 8 8 8 8 4 4 4 4 4 4 9 4 8 4 4 4 4 2
2 5 5 5 6 5 5 5 5 5 5 7 6 6 6 6 6 6 6 6 6 6 7 6 6 6 6 6 6 6 6 6 6 7 6 6 6 5 6 5 5 5 5 5 7 5 0 0 0 0 0 0 0 0 8 4 4 4 4 4 4 4 8 8 8 8 8 8 8 9 8 8 8 8 8 8 8 8 8 8 8 8 8 8 8 8 8 4 4 4 4 4 9 4 4 4 4 4 4 2
2 5 5 5 5 5 5 5 5 6 7 6 6 6 6 6 6 6 6 6 6 7 6 6 6 6 6 6 6 6 6 6 7 6 6 6 6 6 5 5 5 5 5 7 5 5 0 0 0 0 0 0 0 0 4 4 4 4 4 4 4 8 8 8 8 8 8 8 8 9 8 8 8 8 8 8 8 8 8 8 8 8 8 8 8 8 8 8 4 4 8 4 9 4 4 4 4 4 4 2
2 5 5 5 5 5 5 5 5 7 6 6 6 6 6 6 6 6 6 6 7 6 6 6 6 6 6 6 6 6 6 7 6 6 6 6 6 6 6 5 5 5 7 5 5 5 0 0 0 0 0 0 0 0 4 4 4 4 4 4 8 8 8 8 8 8 8 8 8 9 8 8 8 8 8 8 8 8 8 8 8 8 8 8 8 8 8 8 8 4 4 4 9 4 4 4 4 4 4 2
2 5 6 5 5 5 5 5 7 5 6 6 6 6 6 6 6 6 6 7 6 6 6 6 6 6 6 6 6 6 7 6 6 6 6 6 6 6 6 5 5 7 5 5 5 5 0 0 0 0 0 0 0 0 1 4 4 4 4 4 8 8 1 8 8 8 1 8 8 9 4 8 8 8 1 8 8 8 1 8 8 8 4 8 8 8 1 8 8 4 1 4 9 4 4 4 4 4 4 2
2 5 5 5 5 5 5 7 5 6 6 6 6 6 6 6 6 6 7 6 7 7 7 7 6 7 7 7 7 7 6 6 6 6 6 6 6 6 6 6 7 6 5 5 5 5 0 0 0 0 0 0 0 0 4 4 4 4 4 8 8 8 8 8 8 8 8 8 8 9 8 8 8 8 8 8 8 8 8 8 8 8 8 8 8 8 8 8 8 8 4 4 9 4 4 4 4 4 4 2
2 5 5 5 5 5 7 5 6 6 6 6 6 6 6 6 6 7 6 7 7 7 7 7 7 7 7 7 7 6 6 6 6 6 6 6 6 6 6 7 6 5 5 5 5 5 0 0 0 0 0 0 0 0 4 4 4 4 8 8 8 8 8 8 8 8 8 8 8 9 9 9 9 9 9 9 9 9 9 8 8 8 8 8 8 8 8 8 8 8 8 4 9 4 4 4 4 4 4 2
2 5 5 5 5 7 5 5 6 6 6 6 6 6 6 6 7 6 7 7 7 7 7 7 7 7 7 7 7 7 7 7 6 6 6 6 6 6 7 6 6 5 5 5 5 5 0 0 0 0 0 0 0 0 4 4 4 4 8 8 8 8 8 8 8 8 8 8 8 9 9 9 9 9 9 9 9 9 9 9 8 8 8 8 8 8 8 8 8 8 8 4 9 4 4 4 4 4 4 2
2 5 5 5 7 6 5 5 6 6 6 6 6 6 6 7 6 7 7 7 7 7 5 7 7 7 7 7 7 7 7 7 5 5 6 6 6 7 6 6 6 5 5 5 5 5 0 0 0 0 0 0 0 0 4 4 4 4 8 8 8 8 8 8 8 8 8 8 9 9 9 9 9 9 9 9 9 9 8 9 9 8 8 8 8 8 8 8 8 8 8 4 9 4 4 4 4 8 4 2
2 5 5 7 5 5 5 6 6 6 6 6 6 6 7 6 7 7 7 7 7 7 7 7 7 7 7 5 7 7 7 7 7 5 6 6 7 6 6 6 6 6 5 5 6 5 0 0 0 0 0 0 0 0 4 4 4 8 8 8 8 8 8 8 8 8 8 9 9 9 9 9 9 9 9 9 8 9 9 9 9 9 8 8 8 8 8 8 8 8 8 8 9 4 4 8 4 4 4 2
2 5 7 5 5 5 5 6 6 6 6 6 6 7 6 6 7 7 7 7 7 7 7 7 7 7 7 7 7 7 7 7 5 7 6 7 6 6 6 6 6 6 5 5 5 5 0 0 0 0 0 0 0 0 1 8 4 8 4 8 8 8 1 8 8 8 1 9 9 9 4 9 9 9 1 9 9 9 1 9 9 9 4 8 8 8 1 8 8 8 1 8 9 8 4 4 4 4 4 2
2 7 5 6 5 5 5 6 6 6 6 6 7 6 6 7 7 7 7 7 5 7 7 7 7 7 7 7 7 7 7 7 7 7 7 6 6 6 6 6 6 6 5 5 5 7 0 0 0 0 0 0 0 0 4 4 4 8 8 8 8 8 8 8 8 8 9 9 9 9 9 9 8 9 9 9 9 9 9 9 9 9 9 8 8 8 8 8 8 8 8 8 9 4 4 4 4 4 4 2
2 5 5 5 5 5 5 6 6 6 6 7 6 6 6 7 7 7 7 7 7 7 7 7 7 5 7 7 7 7 7 7 7 7 6 6 6 6 6 6 6 6 6 5 7 5 0 0 0 0 0 0 0 0 4 4 4 8 8 8 8 8 8 8 8 8 9 9 9 9 8 9 9 9 9 9 9 9 9 9 9 9 9 8 8 8 8 8 8 8 8 8 9 4 4 4 4 4 4 2
2 5 5 5 5 5 5 6 6 6 7 6 6 6 6 7 7 7 7 7 7 7 7 7 7 7 7 7 7 7 5 7 7 7 6 6 6 6 6 6 6 6 5 7 5 5 0 0 0 0 0 0 0 0 9 9 9 9 9 9 9 9 9 9 9 9 9 9 9 9 9 9 9 9 9 9 9 9 9 9 9 9 9 9 9 9 9 9 9 9 9 9 9 9 9 9 9 9 9 2
2 6 5 5 5 5 5 6 6 7 6 6 6 6 6 7 7 7 5 7 7 7 7 7 7 7 7 7 7 7 7 7 7 7 6 6 6 6 6 6 6 6 7 5 5 5 0 0 0 0 0 0 0 0 4 4 4 8 8 8 8 8 8 8 8 8 8 9 9 9 9 9 9 9 9 9 9 9 9 9 9 9 9 8 8 8 8 8 8 8 8 8 9 4 4 4 4 4 4 2
2 5 5 5 5 5 6 6 7 6 6 6 6 6 6 7 7 7 7 7 7 7 7 5 7 7 7 7 7 7 7 7 7 7 6 6 6 6 6 6 6 7 5 5 5 5 0 0 0 0 0 0 0 0 4 4 4 8 8 8 8 8 8 8 8 8 9 9 9 9 9 9 9 9 9 9 9 9 9 9 9 9 9 8 8 8 8 8 8 8 8 8 9 4 4 4 4 4 4 2
2 5 5 5 5 5 5 7 6 6 6 6 6 6 6 7 7 7 7 7 7 7 7 7 7 7 7 7 5 7 7 7 7 7 6 6 6 6 6 6 7 6 5 5 5 6 0 0 0 0 0 0 0 0 1 4 4 8 4 8 8 8 1 8 8 8 1 9 9 9 4 9 9 9 1 9 9 9 1 9 9 8 4 8 8 8 1 8 8 8 1 8 9 4 4 4 4 4 4 2
2 5 5 5 5 5 7 6 6 6 6 6 6 6 6 7 6 7 7 7 7 7 7 7 7 7 7 7 7 7 7 7 7 5 6 6 6 6 6 7 6 6 5 5 5 5 0 0 0 0 0 0 0 0 4 4 4 8 8 8 8 8 8 8 8 8 9 9 9 9 9 9 9 9 9 9 9 9 9 8 9 9 9 8 8 8 8 8 8 8 8 8 9 4 4 4 4 4 8 2
2 5 5 5 6 7 5 6 6 6 6 6 6 6 6 7 7 7 7 7 7 5 7 7 7 7 7 7 7 7 7 7 7 7 6 6 6 6 7 6 6 6 5 5 5 5 0 0 0 0 0 0 0 0 4 4 4 8 8 8 8 8 8 8 8 8 9 9 9 9 9 9 9 9 9 9 9 8 9 9 9 9 9 8 8 8 8 8 8 8 8 8 9 4 4 4 8 4 4 2
2 5 5 5 7 5 5 6 6 6 6 6 6 6 6 7 7 7 7 7 7 7 7 7 7 7 7 7 7 7 7 7 7 5 6 6 6 7 6 6 6 6 5 6 5 5 0 0 0 0 0 0 0 0 4 4 8 8 8 8 8 8 8 8 8 8 8 9 9 9 9 9 9 9 9 8 9 9 9 9 9 9 8 8 8 8 8 8 8 8 8 8 9 4 8 4 4 4 4 2
2 5 5 7 5 5 5 5 6 6 6 6 6 6 7 6 6 7 7 7 7 7 7 7 7 7 7 7 7 7 7 5 5 5 6 6 7 6 6 6 6 5 5 5 5 5 0 0 0 0 0 0 0 0 8 4 4 4 8 8 8 8 8 8 8 8 8 8 9 9 9 9 9 8 9 9 9 9 9 9 9 8 8 8 8 8 8 8 8 8 8 4 9 4 4 4 4 4 4 2
2 5 7 5 5 5 5 5 6 6 6 6 6 7 6 6 6 7 7 5 7 7 7 7 7 7 7 7 7 7 7 7 5 5 6 7 6 6 6 6 6 5 5 5 5 5 0 0 0 0 0 0 0 0 4 4 4 4 8 8 8 8 8 8 8 8 8 8 8 9 9 8 9 9 9 9 9 9 9 9 8 8 8 8 8 8 8 8 8 8 8 4 9 4 4 4 4 4 4 2
2 7 5 5 5 5 5 6 6 6 6 6 7 6 6 6 6 6 5 7 7 7 7 7 5 7 7 7 7 7 5 5 5 5 7 6 6 6 6 6 6 6 5 5 5 7 0 0 0 0 0 0 0 0 1 4 4 4 4 8 8 8 1 8 8 8 1 8 8 9 4 9 9 9 1 9 9 9 1 8 8 8 4 8 8 8 1 8 8 8 1 4 9 4 4 4 4 4 4 2
2 5 5 5 5 5 5 5 5 6 6 7 6 6 6 6 6 6 5 5 7 7 7 7 7 7 7 7 7 5 5 5 5 7 6 6 6 6 6 6 5 5 5 5 7 5 0 0 0 0 0 0 0 0 4 4 4 4 4 8 8 8 8 8 8 8 8 8 8 9 8 8 8 8 8 8 8 8 8 8 8 8 8 8 8 8 8 8 8 8 4 4 9 4 4 4 4 4 4 2
2 5 5 5 5 5 5 5 5 5 7 6 6 6 6 6 6 6 6 6 6 7 6 6 6 6 6 6 6 6 6 6 7 6 6 6 6 6 6 5 5 5 5 7 5 5 0 0 0 0 0 0 0 0 4 4 4 4 4 4 8 8 8 8 8 8 8 8 8 9 8 8 8 8 8 8 8 8 8 8 8 8 8 8 8 8 8 8 8 4 4 4 9 4 4 4 4 4 4 2
2 5 5 5 5 6 5 5 5 7 6 6 6 6 6 6 6 6 6 6 7 6 6 6 6 6 6 6 6 6 6 7 6 6 6 6 6 6 6 6 5 5 7 5 5 5 0 0 0 0 0 0 0 0 4 4 4 4 4 4 8 8 8 8 8 8 8 8 8 9 8 8 8 8 8 8 8 8 8 8 8 8 8 8 8 8 8 8 8 4 4 4 9 4 4 4 4 4 4 2
2 5 5 5 5 5 5 5 7 5 6 6 6 6 6 6 6 6 6 7 6 6 6 6 6 6 6 6 6 6 7 6 6 6 6 6 6 6 5 5 5 7 5 5 6 5 0 0 0 0 0 0 0 0 4 4 4 4 4 4 4 8 8 8 8 8 8 8 8 9 8 8 8 8 8 8 8 8 8 8 8 8 8 8 8 8 8 8 4 4 4 4 9 4 4 4 4 4 4 2
2 5 5 5 5 5 5 7 5 5 5 5 6 6 6 6 6 6 7 6 6 6 6 6 6 6 6 6 6 7 6 6 6 6 6 6 6 5 5 5 7 5 5 5 5 5 0 0 0 0 0 0 0 0 4 4 4 4 4 8 4 4 8 8 8 8 8 8 8 9 8 8 8 8 8 8 8 8 8 8 8 8 8 8 8 8 8 4 4 4 4 4 9 4 4 4 4 8 4 2
2 5 5 6 5 5 7 5 5 5 5 5 5 6 6 6 6 7 6 6 6 6 6 6 6 6 6 6 7 6 6 6 6 6 6 6 5 6 5 7 5 5 5 5 5 5 0 0 0 0 0 0 0 0 1 4 4 8 4 4 4 4 1 8 8 8 1 8 8 9 4 8 8 8 1 8 8 8 1 8 8 8 4 8 8 8 1 4 4 4 1 4 9 4 4 8 4 4 4 2
2 5 5 5 5 7 5 5 6 5 5 5 5 5 5 6 7 6 6 6 6 6 6 6 6 6 6 7 6 6 6 6 6 6 5 5 5 5 7 5 5 5 6 5 5 5 0 0 0 0 0 0 0 0 4 8 4 4 4 4 4 4 4 4 4 8 8 8 8 9 8 8 8 8 8 8 8 8 8 8 8 8 8 8 4 4 4 4 4 4 4 4 9 8 4 4 4 4 4 2
2 5 5 5 7 5 5 5 5 5 5 5 5 6 5 7 6 6 6 6 6 6 6 6 6 6 7 6 6 6 6 6 6 5 5 5 5 7 5 5 5 1 5 5 1 5 0 1 0 0 1 0 0 1 4 4 1 4 4 1 4 4 4 4 4 4 8 8 8 9 8 8 8 8 8 8 8 8 8 8 8 8 8 4 4 4 4 4 4 4 4 8 9 4 4 4 4 4 4 2
2 6 5 7 5 5 5 5 5 5 5 5 5 5 7 5 5 5 6 6 6 6 6 6 6 7 6 6 6 6 5 5 5 5 5 6 7 5 5 5 1 5 5 1 5 5 1 0 0 1 0 0 1 0 4 1 4 4 1 4 4 4 4 4 4 4 4 4 4 9 8 8 8 8 8 8 8 8 8 8 4 4 4 4 4 4 4 4 4 8 4 4 9 4 4 4 4 4 4 2
2 5 7 5 5 5 6 5 5 5 5 5 5 7 5 5 5 5 5 5 5 5 5 6 7 5 5 5 5 5 5 5 5 5 5 7 5 5 5 5 6 5 1 5 5 1 0 0 1 0 0 1 0 0 1 4 4 1 4 4 4 4 4 4 4 4 4 4 8 9 4 4 4 4 4 4 4 4 4 4 4 4 4 4 4 4 4 8 4 4 4 4 9 4 4 4 4 4 4 2
2 7 5 5 5 5 5 5 5 5 5 6 7 5 5 5 5 5 5 5 5 5 5 7 5 5 5 5 6 5 5 5 5 5 7 5 5 5 5 5 5 1 5 5 1 7 0 1 0 0 1 0 0 1 4 4 1 4 4 1 4 4 4 4 4 4 8 4 4 9 4 4 4 4 4 4 4 4 4 4 4 4 4 4 4 8 4 4 4 4 4 4 9 4 4 4 4 4 4 2
2 5 5 5 5 5 5 5 5 5 5 7 5 5 5 5 6 5 5 5 5 5 7 5 5 5 5 5 5 5 5 5 5 7 5 5 5 5 5 5 1 5 5 1 7 5 1 0 0 1 0 0 1 0 4 1 4 4 1 1 1 1 1 4 8 4 4 4 4 9 4 4 4 4 4 4 4 4 4 4 4 4 4 8 4 4 4 4 4 4 4 4 9 4 4 4 4 4 4 2
2 5 5 5 6 5 5 5 5 5 7 5 5 5 5 5 5 5 5 5 5 7 5 5 5 5 5 5 5 5 5 5 7 5 5 5 5 5 6 5 5 5 1 7 5 1 0 0 1 0 0 1 0 0 1 4 4 1 1 1 1 1 1 4 4 4 4 4 4 9 4 4 4 4 4 4 4 4 4 4 4 8 4 4 4 4 4 4 4 4 4 4 9 4 4 4 4 4 4 2
2 0 0 0 0 0 0 0 0 0 0 0 0 0 0 0 0 0 0 0 0 0 0 0 0 0 0 0 0 0 0 0 0 0 0 0 0 0 0 0 0 1 0 0 1 0 0 1 0 0 1 0 0 1 0 0 1 0 0 1 0 0 0 0 0 0 0 0 0 0 0 0 0 0 0 0 0 0 0 0 0 0 0 0 0 0 0 0 0 0 0 0 0 0 0 0 0 0 0 2
2 0 0 0 0 0 0 0 0 0 0 0 0 0 0 0 0 0 0 0 0 0 0 0 0 0 0 0 0 0 0 0 0 0 0 0 0 0 0 0 1 0 0 1 0 0 1 0 0 1 0 0 1 0 0 1 0 0 1 0 0 0 0 0 0 0 0 0 0 0 0 0 0 0 0 0 0 0 0 0 0 0 0 0 0 0 0 0 0 0 0 0 0 0 0 0 0 0 0 2
2 0 0 0 0 0 0 0 0 0 0 0 0 0 0 0 0 0 0 0 0 0 0 0 0 0 0 0 0 0 0 0 0 0 0 0 0 0 0 0 0 0 1 0 0 1 0 0 1 1 1 1 0 0 1 0 0 1 0 0 0 0 0 0 0 0 0 0 0 0 0 0 0 0 0 0 0 0 0 0 0 0 0 0 0 0 0 0 0 0 0 0 0 0 0 0 0 0 0 2
2 0 0 0 0 0 0 0 0 0 0 0 0 0 0 0 0 0 0 0 0 0 0 0 0 0 0 0 0 0 0 0 0 0 0 0 0 0 0 0 0 1 0 0 1 0 0 1 1 1 1 1 0 1 0 0 1 0 0 1 0 0 0 0 0 0 0 0 0 0 0 0 0 0 0 0 0 0 0 0 0 0 0 0 0 0 0 0 0 0 0 0 0 0 0 0 0 0 0 2
2 0 0 0 0 0 0 0 0 0 0 0 0 0 0 0 0 0 0 0 0 0 0 0 0 0 0 0 0 0 0 0 0 0 0 0 0 0 0 0 1 0 0 1 0 0 1 0 1 1 1 1 1 0 0 1 0 0 1 0 0 0 0 0 0 0 0 0 0 0 0 0 0 0 0 0 0 0 0 0 0 0 0 0 0 0 0 0 0 0 0 0 0 0 0 0 0 0 0 2
2 0 0 0 0 0 0 0 0 0 0 0 0 0 0 0 0 0 0 0 0 0 0 0 0 0 0 0 0 0 0 0 0 0 0 0 0 0 0 0 0 0 1 0 0 1 0 0 1 1 1 1 0 0 1 0 0 1 0 0 0 0 0 0 0 0 0 0 0 0 0 0 0 0 0 0 0 0 0 0 0 0 0 0 0 0 0 0 0 0 0 0 0 0 0 0 0 0 0 2
2 0 0 0 0 0 0 0 0 0 0 0 0 0 0 0 0 0 0 0 0 0 0 0 0 0 0 0 0 0 0 0 0 0 0 0 0 0 0 0 0 1 0 0 1 0 0 1 0 0 1 0 0 1 0 0 1 0 0 1 0 0 0 0 0 0 0 0 0 0 0 0 0 0 0 0 0 0 0 0 0 0 0 0 0 0 0 0 0 0 0 0 0 0 0 0 0 0 0 2
2 0 0 0 0 0 0 0 0 0 0 0 0 0 0 0 0 0 0 0 0 0 0 0 0 0 0 0 0 0 0 0 0 0 0 0 0 0 0 0 1 0 0 1 0 0 1 0 0 1 0 0 1 0 0 1 0 0 1 0 0 0 0 0 0 0 0 0 0 0 0 0 0 0 0 0 0 0 0 0 0 0 0 0 0 0 0 0 0 0 0 0 0 0 0 0 0 0 0 2
2 A A 3 A A A A A A A A A A B A A A 3 A A A A A A A A A A A A A A 3 A A B A A A A A 1 A A 1 0 0 1 0 0 1 0 0 1 0 0 1 0 0 0 1 1 1 1 1 0 0 0 0 0 0 0 0 0 0 0 0 0 0 0 0 0 0 0 0 C 0 0 0 1 0 0 0 0 0 0 0 0 2
2 A A A A A A A A A 3 B A A A A A A B B B B B B B 3 B B B B B A A B A A A A A A 3 1 A A 1 A 0 1 0 0 1 0 0 1 0 0 1 0 0 1 0 1 1 1 1 1 0 0 0 0 0 0 0 0 0 0 0 0 C 0 0 0 0 0 0 0 0 0 0 1 0 0 0 0 0 0 0 0 1 2
2 A 3 A A A A A B A A A A A A A B 3 B B B B B B B B B B B B B B 3 A A A A A A A 1 A A 1 A A 1 0 0 1 0 0 1 0 0 1 0 0 1 0 0 1 1 1 1 1 1 0 0 0 C 0 0 0 0 0 0 0 0 0 0 0 0 0 0 0 0 0 1 0 0 0 0 0 0 0 0 1 0 2
2 A A A A B A A A 3 A A A A B B B B B B B B B B 3 B B B B B B B B B B A A A A 3 A A 1 A A 1 0 0 1 0 0 1 0 0 1 0 0 1 0 0 1 0 1 1 1 1 1 0 0 0 0 0 0 0 0 0 0 0 0 0 0 0 0 0 0 0 0 0 0 0 0 0 0 0 0 0 1 0 0 2
2 3 B A A A A A A A A A A B B B 3 B B B B B B B B B B B B B B 3 B B B B A A A A A 1 A A 1 A 0 1 0 0 1 0 0 1 C 0 1 0 0 1 0 0 1 1 1 1 1 0 0 0 0 0 0 0 0 0 0 0 0 0 0 0 0 0 0 0 0 0 0 0 0 C 0 0 0 1 0 0 0 2
2 A A A A A A A 3 A A B B B B B B B B B B B B 3 B B B B B B B B B B B B B B 3 A 1 A A 1 A A 1 0 0 1 0 0 1 0 0 1 0 0 1 0 0 0 0 1 1 1 1 1 0 0 0 0 0 0 0 0 0 0 0 0 0 0 0 C 0 0 0 0 0 0 0 0 0 0 1 0 0 0 0 2
2 A A A A A A A A A B B B B B 3 B B B B B B B B B B B B B B 3 B B B B B B B B A B A A A A 3 0 0 0 0 0 0 0 0 0 0 0 1 0 0 0 0 0 C C C C C 0 0 0 0 0 0 0 C 0 0 0 0 0 0 0 0 0 0 0 0 0 0 0 0 0 1 0 0 0 0 0 2
2 A A A A A A 3 A B B B B B B B B B B B B B 3 B B B B B B B B B B B B B B 3 B B A A A A A A 0 0 0 0 0 0 0 0 0 0 1 0 0 0 0 0 0 C C C C C 0 0 0 0 0 0 0 0 0 0 0 0 0 0 0 0 0 0 0 0 0 0 0 0 1 0 0 0 0 0 0 2
2 A A A A A A A A B B B B B 3 B B B B B B B B B B B B B B 3 B B B B B B B B B B A A A A 3 A 0 0 0 0 0 0 0 0 0 1 0 0 0 C 0 0 0 0 C C C C C 0 0 0 0 0 0 0 0 0 0 0 0 0 0 0 0 0 0 0 0 0 0 0 0 0 0 0 C 0 0 2
2 A A A A A 3 A B B B B B B B B B B B B B 3 B B B B B B B B B B B B B B 3 B B B B A A A A A 0 0 0 0 0 0 0 0 1 0 0 0 0 0 0 0 0 0 C C C C C 0 1 1 1 1 1 1 1 1 1 0 0 0 0 0 0 0 0 0 C 0 0 0 0 0 0 0 0 0 0 2
2 A A A A A B B B B B B B 3 B B B B B B 3 3 3 3 3 3 3 3 3 B B B B B B B B B B B B B A 3 A A 0 0 0 0 0 0 0 0 0 0 0 0 0 0 0 0 0 0 C C C C C 1 1 1 1 1 1 1 1 1 1 1 C 0 0 0 0 0 0 0 0 0 0 0 0 0 0 0 0 0 1 2
2 A A B A 3 A B B B B B B B B B B B 3 3 3 3 3 3 3 B 3 3 3 3 3 B B B B 3 B B B B B B A A A A 0 0 0 0 0 0 0 0 0 0 0 0 0 0 0 0 0 0 0 C C C C C 1 1 C 1 1 1 1 1 1 1 1 1 0 0 0 0 0 0 0 0 0 0 0 0 0 0 0 1 0 2
2 A A A A A B B B B B B 3 B B B B 3 3 3 3 3 B 3 3 3 3 3 3 3 3 3 B B B B B B B B B B 3 A B A 0 0 0 0 0 0 0 0 0 0 0 0 0 0 0 0 0 0 C C C C C C 1 1 1 1 1 1 1 1 1 1 1 1 1 0 0 0 0 0 0 0 0 0 0 0 0 0 1 0 0 2
2 A A A 3 A B B B B B B B B B B 3 3 3 3 3 3 3 3 3 3 3 3 3 3 3 3 3 B 3 B B B B B B B B A A A 0 0 0 0 0 0 0 0 0 0 C 0 0 0 0 0 0 0 0 C C C C C 1 1 1 1 1 1 1 1 1 1 1 1 1 1 0 0 0 0 0 0 0 0 0 C 0 1 0 0 0 2
2 A A A A B B B B B B 3 B B B 3 B 3 3 3 3 3 3 3 3 3 3 3 3 3 3 3 3 3 B B B B B B B 3 B B A A 0 0 0 0 0 0 0 0 0 0 0 0 0 0 0 0 0 0 1 1 C C C C C 1 1 1 1 1 1 1 1 1 1 1 1 1 1 C 0 0 0 0 0 0 0 0 0 0 0 0 0 2
2 A A 3 A B B B B B B B B B B 3 3 3 3 3 3 3 3 3 3 3 3 3 3 3 3 3 3 3 B B B B B B B B B B A A 0 0 0 0 0 0 0 0 0 0 0 0 0 0 0 0 0 0 1 1 C C C C C 1 1 1 1 1 1 C 1 1 1 1 1 1 1 0 0 0 0 0 0 0 0 0 0 0 0 0 0 2
2 A A A A B B B B B 3 B B B 3 3 3 3 3 3 3 3 3 3 3 3 3 3 3 3 3 3 B 3 3 B B B B B 3 B B B A A 0 0 0 0 0 0 0 0 0 0 0 0 0 0 0 0 0 1 1 1 C C C C C 1 1 1 1 1 1 1 1 1 1 1 1 1 1 1 0 0 0 0 0 0 0 0 0 0 0 0 0 2
2 A 3 A A B B B B B B B B B 3 3 3 3 3 3 3 3 3 3 3 3 3 3 3 B 3 3 3 3 3 B B B B B B B B B A A 0 0 0 0 0 0 0 0 0 0 0 0 0 0 0 C 0 1 1 1 1 C C C C C 1 1 1 1 1 1 1 1 1 1 1 1 1 1 0 0 0 0 0 0 0 0 0 0 0 0 C 2
2 A A A B B B B B 3 B B B B 3 3 3 3 3 3 3 3 3 3 3 3 B 3 3 3 3 3 3 3 3 B B B B 3 B B B B A A 0 0 0 0 0 0 0 0 0 0 0 0 0 0 0 0 0 1 1 1 1 C C C C C 1 1 1 1 1 1 1 1 1 1 1 1 1 1 0 0 0 0 C 0 0 0 0 0 0 0 0 2
2 3 A A A B B B B B B B B B 3 3 3 3 3 3 3 3 3 B 3 3 3 3 3 3 3 3 3 3 3 B B B B B B B B B A B 0 0 0 0 0 0 0 0 0 0 0 0 0 0 0 0 0 1 1 1 1 C C C C C 1 1 1 1 1 1 1 1 1 1 C 1 1 1 0 0 0 0 0 0 0 0 0 0 0 0 1 2
2 A A A A B B B 3 B B B B B 3 3 3 3 3 3 B 3 3 3 3 3 3 3 3 3 3 3 3 3 3 B B B 3 B B B B B A A 0 0 0 0 0 0 0 0 0 0 0 0 0 0 0 0 0 1 1 1 1 1 C C C C C 1 C 1 1 1 1 1 1 1 1 1 1 1 0 0 0 0 0 0 0 0 0 0 0 1 0 2
2 A A A A B B B B B B B B B 3 3 3 B 3 3 3 3 3 3 3 3 3 3 3 3 3 3 3 3 3 B B B B B B B B B A 3 0 0 0 0 0 0 0 0 0 0 0 0 0 0 0 0 0 1 1 1 C 1 C C C C C 1 1 1 1 1 1 1 1 1 1 1 1 1 0 0 0 0 0 0 0 0 0 0 1 0 0 2
2 A A A A B B 3 B B B B B B B 3 3 3 3 3 3 3 3 3 3 3 3 3 3 3 3 3 3 3 3 B B 3 B B B B B B A A 0 0 0 0 0 0 0 0 0 0 0 0 C 0 0 0 0 1 1 1 1 1 C C C C C 1 1 1 1 1 1 1 1 1 1 1 1 1 0 0 0 0 0 0 0 0 0 C 0 0 0 2
2 A A A A B B B B B B B B B 3 3 3 3 3 3 3 3 3 3 3 3 3 3 3 3 3 3 3 B 3 B B B B B B B B B 3 A 0 0 0 0 0 0 0 0 0 0 0 0 0 0 0 0 0 1 1 1 1 1 1 C C C C C 1 1 1 1 1 1 1 1 1 1 1 1 0 C 0 0 0 0 0 0 0 0 0 0 0 2
2 A A A A B 3 B B B B B B B 3 3 3 3 3 3 3 3 3 3 3 3 3 3 3 3 B 3 3 3 3 B 3 B B B B B B B A A 0 0 0 0 0 0 0 0 0 0 0 0 0 0 0 0 0 1 1 1 1 1 1 C C C C C 1 1 1 1 1 C 1 1 1 1 1 1 0 0 0 0 0 0 0 0 0 0 0 0 0 2
2 A A A A B B B B B B B B 3 B 3 3 3 3 3 3 3 3 3 3 3 3 B 3 3 3 3 3 3 B B B B B B B B B 3 A A 0 0 0 0 0 0 0 0 0 0 0 0 0 0 0 0 0 0 1 1 1 1 1 C C C C C 1 1 1 1 1 1 1 1 1 1 1 0 0 0 0 0 0 0 0 0 0 0 0 0 0 2
2 A B A A 3 B B B B B B B B B 3 3 3 3 3 3 3 3 3 B 3 3 3 3 3 3 3 3 3 B 3 B B B B B B B B A A 0 0 0 0 0 0 0 0 0 0 0 0 0 0 0 0 0 C 1 1 1 1 1 1 0 0 0 0 0 1 1 1 1 1 1 1 1 1 1 0 0 0 0 0 0 0 0 0 0 0 0 0 0 2
2 A A A A A B B B B B B 3 B B B 3 3 3 3 3 B 3 3 3 3 3 3 3 3 3 3 3 B B B B B B B B B 3 B A A 0 0 0 0 0 0 0 0 0 C 0 0 0 0 0 0 0 0 0 1 1 1 1 1 0 0 0 0 0 1 1 1 1 1 1 1 1 1 0 0 0 0 0 0 0 0 C 0 0 0 0 0 0 2
2 A A A 3 A B B B B B B B B B B B 3 B 3 3 3 3 3 3 3 3 3 3 3 3 3 B B 3 B B B B B B B B A A A 0 0 0 0 0 0 0 0 0 0 0 0 0 0 0 0 0 0 0 0 1 1 1 1 0 0 0 0 0 1 1 1 1 1 1 1 1 0 C 0 0 0 0 0 0 0 0 0 0 0 0 0 1 2
2 A A A A A A B B B B 3 B B B B B B 3 3 3 3 3 3 3 3 3 3 3 3 3 B B B B B B B B B B 3 A A A A 0 0 0 0 0 0 0 0 0 0 0 0 0 0 0 0 0 0 0 0 0 1 1 1 1 0 0 0 0 0 C 1 1 1 1 1 0 0 0 0 0 0 0 0 0 0 0 0 0 0 0 1 0 2
2 A A 3 A A A B B B B B B B B B B B 3 B 3 3 3 3 3 3 3 3 3 B B B B 3 B B B B B B B B A A A A 0 0 0 0 0 0 0 0 0 0 0 0 0 0 0 0 0 0 0 0 0 0 C 1 1 0 0 0 0 0 1 1 1 1 1 0 0 0 0 0 0 0 0 0 0 0 0 0 0 0 1 0 0 2
2 A A A A A A A B B 3 B B B B B B B B B B B B B B 3 B B B B B B B B B B B B B B 3 A A A A A 0 0 0 0 0 0 0 0 0 0 0 0 0 0 C 0 0 0 0 0 0 0 0 0 1 0 0 0 0 0 1 1 1 0 0 0 0 0 0 0 0 0 0 0 0 0 0 0 0 1 0 C 0 2
2 A 3 A A A B A A B B B B B B B B 3 B B B B B B B B B B B B B B 3 B B B B B B B A A A A A A 0 0 0 0 0 0 0 0 0 0 0 0 0 0 0 0 0 0 0 0 0 0 0 0 0 0 0 0 0 0 0 0 0 0 0 0 0 0 0 0 0 0 0 C 0 0 0 0 1 0 0 0 0 2
2 A A B A A A A A 3 B B B B B B B B B B B B B B 3 B B B B B B B B B B B B B B 3 A A A A A A 0 0 0 0 0 0 0 0 0 0 0 0 0 0 0 0 0 0 0 0 0 0 0 0 0 0 0 0 0 0 0 0 0 0 0 C 0 0 0 0 0 0 0 0 0 0 0 1 0 0 0 0 0 2
2 3 A A A A A A A A B B B B B B 3 B B B B B B B B B B B B B B 3 B B B B B B B A A A A A B A 0 0 0 0 0 0 0 0 0 0 1 0 0 0 0 0 0 0 0 0 0 0 0 0 0 0 0 0 0 0 0 0 0 0 0 0 0 0 0 0 0 0 0 0 0 0 1 0 0 0 0 0 0 2
2 A A A A A A A 3 A A B B B B B B B B B B B B 3 B B B B B B B B B B B B B B 3 A A B A A A A 0 0 0 0 0 0 0 0 0 1 0 0 0 0 0 0 0 0 0 C 0 0 0 0 0 0 0 0 0 0 0 0 0 0 0 0 0 0 0 0 0 0 0 0 0 1 0 0 0 0 0 0 0 2
2 A A A A A A A A A A A A B B 3 B B B B B B B B B B B B B B 3 B B B B B A A B A A A A A A 3 0 0 0 0 0 0 0 0 1 0 0 C 0 0 0 0 0 0 0 0 0 0 0 0 0 0 0 0 0 0 0 0 0 0 0 0 0 0 0 0 0 0 0 0 1 0 0 0 C 0 0 0 0 2
2 A A A A A A 3 A A A A A B B B B B B B B B 3 B B B B B B B B B B B B B A 3 A A A A A A A A 0 0 0 0 0 0 0 0 0 0 0 0 0 0 0 0 0 0 0 0 0 0 0 0 0 0 0 0 0 0 0 0 0 0 0 0 0 0 0 0 C 0 0 1 0 0 0 0 0 0 0 0 1 2
2 A A A A A A A A A B A A A 3 A B B B B B B B B B B B B B 3 B B B A A A A A A A A A A A 3 A 0 0 0 0 0 0 0 0 0 0 0 0 0 0 0 1 0 0 0 0 0 0 0 0 0 0 0 0 0 0 0 0 0 0 0 0 0 0 0 0 0 0 1 0 0 0 0 0 0 0 0 1 0 2
2 A A A A A 3 B A A A A A A A A A A B B B 3 B B B B B B B B B A A A A A 3 A A A A A A A A A 0 0 0 0 0 0 0 0 0 0 0 0 0 0 1 0 0 0 0 0 0 0 0 0 C 0 0 0 0 0 0 0 0 0 0 0 0 0 0 0 0 1 0 0 0 0 0 0 0 0 1 0 0 2
2 A A A B A A A A A A A A 3 A A A A A A A A A A A A B A 3 A A A A A A A A A A A A A A 3 A A 0 0 0 0 0 0 0 0 0 0 0 0 0 1 0 0 C 0 0 0 0 0 0 0 0 0 0 0 0 0 0 0 0 0 0 0 0 0 0 0 1 0 0 0 0 0 0 0 0 1 0 0 0 2
2 B A A A 3 A A A A A A A A A A A A A A 3 A A B A A A A A A A A A A A 3 A A A A A A A A A B 0 0 0 0 0 0 0 0 C 0 0 0 1 0 0 0 0 0 0 0 0 1 0 0 0 0 0 0 0 0 0 0 0 0 0 0 0 0 0 1 0 0 0 0 0 C 0 0 1 0 0 0 0 2
2 A A A A A A A A A A A 3 A A A A A A A B A A A A A A 3 A A A A A A A A A A A A A A 3 A A A 0 0 0 0 0 0 0 0 0 0 0 1 0 0 0 0 0 0 0 0 1 0 0 0 0 0 0 0 0 0 0 0 0 0 0 0 0 C 1 0 0 0 0 0 0 0 0 1 0 0 0 0 0 2
2 A A A 3 A A A A A A A A A A A A B A 3 A A A A A A A A A A A A A A 3 A A A A B A A A A A A 0 0 0 0 0 0 0 0 0 0 1 0 0 0 0 0 0 0 0 1 0 0 0 0 0 0 0 0 1 0 0 0 0 0 0 0 0 1 0 0 0 0 0 0 0 0 1 0 0 0 0 0 0 2
2 A A A A A A A A A A 3 A A B A A A A A A A A A A A 3 A A A A A A A A A B A A A A 3 A A A A 0 0 0 0 0 0 0 0 0 1 0 0 0 0 0 0 0 0 1 0 0 C 0 0 0 0 0 1 0 0 0 0 0 0 0 0 1 0 0 0 0 0 0 0 0 1 0 0 0 0 0 0 0 2
2 2 2 2 2 2 2 2 2 2 2 2 2 2 2 2 2 2 2 2 2 2 2 2 2 2 2 2 2 2 2 2 2 2 2 2 2 2 2 2 2 2 2 2 2 2 2 2 2 2 2 2 2 2 2 2 2 2 2 2 2 2 2 2 2 2 2 2 2 2 2 2 2 2 2 2 2 2 2 2 2 2 2 2 2 2 2 2 2 2 2 2 2 2 2 2 2 2 2 2
R 12 18 1 1
R 20 28 1 1
R 32 16 1 1
R 40 30 1 1
R 18 36 1 1
R 70 18 2 1
R 82 22 2 1
R 64 30 2 1
R 90 28 2 1
R 76 36 2 1
R 16 70 3 1
R 28 82 3 1
R 34 64 3 1
R 40 90 3 1
R 22 76 3 1
