100 100
0 0 0 0 0 0 0 0 0 0 3 0 0 0 0 0 0 0 0 0 0 0 0 0 0 0 0 0 0 0 0 0 0 3 0 0 0 0 0 0 0 0 0 0 0 2 2 2 2 2 2 2 2 2 2 0 3 0 0 0 0 0 0 0 0 0 0 0 0 0 0 0 0 0 0 0 0 0 0 3 0 0 0 0 0 0 0 0 0 0 0 0 0 0 0 0 0 0 0 0
1 0 0 0 0 0 0 0 0 0 0 0 0 0 0 0 0 0 1 0 0 0 0 0 0 0 0 0 0 0 0 0 0 0 0 0 1 0 0 0 0 0 0 0 0 2 2 2 2 2 2 2 2 2 2 0 0 0 0 0 0 0 0 0 0 0 0 0 0 0 0 0 1 0 0 0 0 0 0 0 0 0 0 0 0 0 0 0 0 0 1 0 0 0 0 0 0 0 0 0
1 0 0 0 0 0 0 0 0 0 0 0 0 0 0 0 0 0 1 0 0 0 0 0 0 0 0 0 0 0 0 0 0 0 0 0 1 0 0 0 0 0 0 0 0 2 2 2 2 2 2 2 2 2 2 0 0 0 0 0 0 0 0 0 0 0 0 0 0 0 0 0 1 0 0 0 0 0 0 0 0 0 0 0 0 0 0 0 0 0 1 0 0 0 0 0 0 0 0 0
0 0 0 0 0 0 0 0 0 0 0 0 0 0 0 0 0 0 0 0 0 0 0 0 0 0 0 0 0 0 0 0 0 0 0 0 0 0 0 0 0 0 0 0 0 2 2 2 2 2 2 2 2 2 2 0 0 0 0 0 0 0 0 0 0 0 0 0 0 0 0 0 0 0 0 0 0 0 0 0 0 0 0 0 0 0 0 0 0 0 0 0 0 0 0 0 0 0 0 0
0 0 0 0 0 0 0 0 0 0 0 0 0 0 0 0 0 0 0 0 0 0 0 0 0 0 0 0 0 0 0 0 0 0 0 0 0 0 0 0 0 0 0 0 0 2 2 2 2 2 2 2 2 2 2 0 0 0 0 0 0 0 0 0 0 0 0 0 0 0 0 0 0 0 0 0 0 0 0 0 0 0 0 0 0 0 0 0 0 0 0 0 0 0 0 0 0 0 0 0
0 0 0 0 0 3 0 0 0 0 0 0 0 0 0 0 0 0 0 0 0 0 0 0 0 0 0 0 3 0 0 0 0 0 0 0 0 0 0 0 0 0 0 0 0 2 2 2 2 2 2 2 2 2 2 0 0 0 0 0 0 0 0 0 0 0 0 0 0 0 0 0 0 0 3 0 0 0 0 0 0 0 0 0 0 0 0 0 0 0 0 0 0 0 0 0 0 3 0 0
0 0 0 0 0 0 0 0 0 0 0 0 0 0 0 0 0 0 0 0 0 0 0 0 0 0 0 0 0 0 0 0 0 0 0 0 0 0 0 0 0 0 0 0 0 2 2 2 2 2 2 2 2 2 2 0 0 0 0 0 0 0 0 0 0 0 0 0 0 0 0 0 0 0 0 0 0 0 0 0 0 0 0 0 0 0 0 0 0 0 0 0 0 0 0 0 0 0 0 0
0 0 0 0 0 0 0 0 0 0 0 0 0 0 0 0 0 0 0 0 0 0 0 0 0 0 0 0 0 0 0 0 0 0 0 0 0 0 0 0 0 0 0 0 0 2 2 2 2 2 2 2 2 2 2 0 0 0 0 0 0 0 0 0 0 0 0 0 0 0 0 0 0 0 0 0 0 0 0 0 0 0 0 0 0 0 0 0 0 0 0 0 0 0 0 0 0 0 0 0
0 0 0 0 0 0 0 0 0 0 0 0 0 0 0 0 0 0 0 0 0 0 0 0 0 0 0 0 0 0 0 0 0 0 0 0 0 0 0 0 0 0 0 0 0 2 2 2 2 2 2 2 2 2 2 0 0 0 0 0 0 0 0 0 0 0 0 0 0 0 0 0 0 0 0 0 0 0 0 0 0 0 0 0 0 0 0 0 0 0 0 0 0 0 0 0 0 0 0 0
0 0 0 0 0 0 0 0 0 0 0 0 0 0 0 1 0 0 0 0 0 0 0 0 0 0 0 0 0 0 0 0 0 1 0 0 0 0 0 0 0 0 0 0 0 2 2 2 2 2 2 2 2 2 2 0 0 0 0 0 0 0 0 0 0 0 0 0 0 1 0 0 0 0 0 0 0 0 0 0 0 0 0 0 0 0 0 1 0 0 0 0 0 0 0 0 0 0 0 0
3 0 0 0 0 0 0 0 0 0 0 0 0 0 0 1 0 0 0 0 0 0 0 3 0 0 0 0 0 0 0 0 0 1 0 0 0 0 0 0 0 0 0 0 0 2 2 2 2 2 2 2 2 2 2 0 0 0 0 0 0 0 0 0 0 0 0 0 0 1 0 0 0 0 0 0 0 0 0 0 0 0 0 0 0 0 0 1 0 0 0 0 3 0 0 0 0 0 0 0
0 0 0 0 0 0 0 0 0 0 0 0 0 0 0 1 0 0 0 0 0 0 0 0 0 0 0 0 0 0 0 0 0 1 0 0 0 0 0 0 0 0 0 0 0 2 2 2 2 2 2 2 2 2 2 0 0 0 0 0 0 0 0 0 0 0 0 0 0 1 0 0 0 0 0 0 0 0 0 0 0 0 0 0 0 0 0 1 0 0 0 0 0 0 0 0 0 0 0 0
0 0 0 0 0 0 0 0 0 0 0 0 0 0 0 0 0 0 0 0 0 0 0 0 0 0 0 0 0 0 0 0 0 0 0 0 0 0 0 0 0 0 0 0 0 2 2 2 2 2 2 2 2 2 2 0 0 0 0 0 0 0 0 0 0 0 0 0 0 0 0 0 0 0 0 0 0 0 0 0 0 0 0 0 0 0 0 0 0 0 0 0 0 0 0 0 0 0 0 0
0 0 0 0 0 0 0 0 0 0 0 0 0 0 0 0 0 0 0 0 0 0 0 0 0 0 0 0 0 0 0 0 0 0 0 0 0 0 0 0 0 0 0 0 0 2 2 2 2 2 2 2 2 2 2 0 0 0 0 0 0 0 0 0 0 0 0 0 0 0 0 0 0 0 0 0 0 0 0 0 0 0 0 0 0 0 0 0 0 0 0 0 0 0 0 0 0 0 0 0
0 0 0 0 0 0 0 0 0 0 0 0 0 0 0 0 0 0 0 0 0 0 0 0 0 0 0 0 0 0 0 0 0 0 0 0 0 0 0 0 0 0 0 0 0 2 2 2 2 2 2 2 2 2 2 0 0 0 0 0 0 0 0 0 0 0 0 0 0 0 0 0 0 0 0 0 0 0 0 0 0 0 0 0 0 0 0 0 0 0 0 0 0 0 0 0 0 0 0 0
0 0 0 0 0 0 0 0 0 0 0 0 0 0 0 0 0 0 3 0 0 0 0 0 0 0 0 0 0 0 0 0 0 0 0 0 0 0 0 0 0 3 0 0 0 2 2 2 2 2 2 2 2 2 2 0 0 0 0 0 0 0 0 0 3 0 0 0 0 0 0 0 0 0 0 0 0 0 0 0 0 0 0 0 0 0 0 3 0 0 0 0 0 0 0 0 0 0 0 0
0 0 0 0 0 0 0 0 0 0 0 0 0 0 0 0 0 0 0 0 0 0 0 0 0 0 0 0 0 0 0 0 0 0 0 0 0 0 0 0 0 0 0 0 0 2 2 2 2 2 2 2 2 2 2 0 0 0 0 0 0 0 0 0 0 0 0 0 0 0 0 0 0 0 0 0 0 0 0 0 0 0 0 0 0 0 0 0 0 0 0 0 0 0 0 0 0 0 0 0
0 0 0 0 0 0 0 0 0 0 0 0 0 0 0 0 0 0 0 0 0 0 0 0 0 0 0 0 0 0 0 0 0 0 0 0 0 0 0 0 0 0 0 0 0 2 2 2 2 2 2 2 2 2 2 0 0 0 0 0 0 0 0 0 0 0 0 0 0 0 0 0 0 0 0 0 0 0 0 0 0 0 0 0 0 0 0 0 0 0 0 0 0 0 0 0 0 0 0 0
0 0 0 0 0 0 0 0 0 0 0 0 1 0 0 0 0 0 0 0 0 0 0 0 0 0 0 0 0 0 1 0 0 0 0 0 0 0 0 0 0 0 0 0 0 2 2 2 2 2 2 2 2 2 2 0 0 0 0 0 0 0 0 0 0 0 1 0 0 0 0 0 0 0 0 0 0 0 0 0 0 0 0 0 1 0 0 0 0 0 0 0 0 0 0 0 0 0 0 0
0 0 0 0 0 0 0 0 0 0 0 0 1 0 0 0 0 0 0 0 0 0 0 0 0 0 0 0 0 0 1 0 0 0 0 0 0 0 0 0 0 0 0 0 0 2 2 2 2 2 2 2 2 2 2 0 0 0 0 0 0 0 0 0 0 0 1 0 0 0 0 0 0 0 0 0 0 0 0 0 0 0 0 0 1 0 0 0 0 0 0 0 0 0 0 0 0 0 0 0
0 0 0 0 0 0 0 0 0 0 0 0 0 3 0 0 0 0 0 0 0 0 0 0 0 0 0 0 0 0 0 0 0 0 0 0 3 0 0 0 0 0 0 0 0 2 2 2 2 2 2 2 2 2 2 0 0 0 0 3 0 0 0 0 0 0 0 0 0 0 0 0 0 0 0 0 0 0 0 0 0 0 3 0 0 0 0 0 0 0 0 0 0 0 0 0 0 0 0 0
0 0 0 0 0 0 0 0 0 0 0 0 0 0 0 0 0 0 0 0 0 0 0 0 0 0 0 0 0 0 0 0 0 0 0 0 0 0 0 0 0 0 0 0 0 2 2 2 2 2 2 2 2 2 2 0 0 0 0 0 0 0 0 0 0 0 0 0 0 0 0 0 0 0 0 0 0 0 0 0 0 0 0 0 0 0 0 0 0 0 0 0 0 0 0 0 0 0 0 0
0 0 0 0 0 0 0 0 0 0 0 0 0 0 0 0 0 0 0 0 0 0 0 0 0 0 0 0 0 0 0 0 0 0 0 0 0 0 0 0 0 0 0 0 0 2 2 2 2 2 2 2 2 2 2 0 0 0 0 0 0 0 0 0 0 0 0 0 0 0 0 0 0 0 0 0 0 0 0 0 0 0 0 0 0 0 0 0 0 0 0 0 0 0 0 0 0 0 0 0
2 2 2 4 4 2 2 2 4 4 2 2 2 4 4 2 2 2 4 4 2 2 2 4 4 2 2 2 4 4 2 2 2 4 4 2 2 2 4 4 2 2 2 4 4 2 2 2 2 2 2 2 2 2 2 2 2 2 4 4 2 2 2 4 4 2 2 2 4 4 2 2 2 4 4 2 2 2 4 4 2 2 2 4 4 2 2 2 4 4 2 2 2 4 4 2 2 2 4 4
4 4 4 4 4 6 4 4 4 4 7 4 4 4 4 4 4 4 4 4 4 4 4 4 6 4 4 7 4 4 4 4 4 4 4 4 4 4 4 4 4 4 4 6 7 4 4 4 4 4 4 4 4 4 4 4 4 4 4 4 4 7 6 4 4 4 4 4 4 4 4 4 4 4 4 4 4 4 7 4 4 6 4 4 4 4 4 4 4 4 4 4 4 4 4 7 4 4 4 4
4 4 5 5 5 4 6 4 4 7 4 4 4 4 5 5 5 4 4 4 4 4 4 4 4 6 5 5 5 4 4 4 4 4 4 4 4 4 5 5 5 4 4 7 6 4 4 4 4 4 4 4 4 4 4 4 4 4 4 4 7 4 5 5 5 4 4 4 4 4 4 4 4 4 5 5 5 7 4 4 4 4 6 4 4 4 5 5 5 4 4 4 4 4 7 4 4 4 5 5
4 4 5 5 5 4 4 6 7 4 4 4 4 4 5 5 5 4 4 4 4 4 4 4 4 7 5 5 5 4 4 4 4 4 4 4 4 4 5 5 5 4 7 4 4 4 4 4 4 4 4 4 4 4 4 4 4 4 4 7 4 4 5 5 5 4 4 4 4 4 4 4 4 4 5 5 5 4 4 4 4 4 4 6 4 4 5 5 5 4 4 4 4 7 4 4 4 4 5 5
4 4 5 5 5 4 4 7 4 4 4 4 4 4 5 5 5 4 4 4 4 4 4 4 7 4 5 5 5 4 4 4 4 4 4 4 4 4 5 5 5 7 4 4 4 4 4 4 4 4 4 4 4 4 4 4 4 4 7 4 4 4 5 5 5 4 4 4 4 4 4 4 4 4 5 5 5 4 4 4 4 4 4 4 4 4 5 5 5 4 4 4 7 4 4 4 4 4 5 5
4 4 4 4 4 4 7 4 4 4 4 4 4 4 4 4 4 4 4 4 4 4 4 7 4 4 4 4 4 4 4 4 4 4 4 4 4 4 4 4 7 4 4 4 4 4 4 4 4 4 4 4 4 4 4 4 4 7 4 4 4 4 4 4 4 4 4 4 4 4 4 4 4 4 7 4 4 4 4 4 4 4 4 4 4 4 4 4 4 4 4 7 4 4 4 4 4 4 4 4
4 4 5 5 5 7 4 4 4 4 4 4 4 4 5 5 5 4 4 4 4 4 7 4 4 4 5 5 5 4 4 4 4 4 4 4 4 4 5 5 5 4 4 4 4 4 4 4 4 4 4 4 4 4 4 4 7 4 4 4 4 4 5 5 5 4 4 4 4 4 4 4 4 7 5 5 5 4 4 4 4 4 4 4 4 4 5 5 5 4 7 4 4 4 4 4 4 4 5 5
4 4 5 5 5 4 4 4 4 4 4 6 4 4 5 5 5 4 4 4 4 7 4 4 4 4 5 5 5 4 6 4 4 4 4 4 4 4 5 5 5 4 4 4 4 4 4 4 4 4 4 4 4 4 4 7 4 4 4 4 4 4 5 5 5 4 4 4 6 4 4 4 7 4 5 5 5 4 4 4 4 4 4 4 4 4 5 5 5 7 4 4 4 4 4 4 4 4 5 5
4 4 5 5 5 4 4 4 4 4 4 4 6 4 5 5 5 4 4 4 7 4 4 4 4 4 5 5 5 4 4 6 4 4 4 4 4 7 5 5 5 4 4 4 4 4 4 4 4 4 4 4 4 4 4 4 4 4 4 4 4 4 5 5 5 4 4 4 4 6 4 7 4 4 5 5 5 4 4 4 4 4 4 4 4 4 5 5 5 4 4 4 4 4 4 4 4 4 5 5
4 4 7 4 4 4 4 4 4 4 4 4 4 6 4 4 4 4 4 7 4 4 4 4 4 4 4 4 4 4 4 4 6 4 4 4 7 4 4 4 4 4 4 4 4 4 4 4 4 4 4 4 4 4 4 4 4 4 4 4 4 4 4 4 4 4 4 4 4 4 7 4 4 4 4 4 4 4 4 4 4 4 4 4 4 4 4 7 4 6 4 4 4 4 4 4 4 4 4 4
4 7 5 5 5 4 4 4 4 4 4 4 4 4 5 5 5 4 7 4 4 4 4 4 4 4 5 5 5 4 4 4 4 4 4 7 4 4 5 5 5 4 4 4 4 4 4 4 4 4 4 4 4 4 4 4 4 4 4 4 4 4 5 5 5 4 4 4 4 7 4 4 4 4 5 5 5 4 4 4 4 4 4 4 4 4 5 5 5 4 4 4 4 4 4 4 4 4 5 5
7 4 5 5 5 4 4 4 4 4 4 4 4 4 5 5 5 7 4 4 4 4 4 4 4 4 5 5 5 4 4 4 4 4 7 4 4 4 5 5 5 4 4 4 4 4 4 4 4 4 4 4 4 4 4 4 4 4 4 4 4 4 5 5 5 4 4 4 7 4 4 4 4 4 5 5 5 4 4 4 4 4 4 4 4 7 5 5 5 4 4 4 4 4 4 4 4 4 5 5
4 4 5 5 5 4 4 4 4 4 4 4 4 4 5 5 5 4 4 4 4 4 4 4 4 4 5 5 5 4 4 4 4 7 4 4 4 4 5 5 5 4 4 4 4 4 4 4 4 4 4 4 4 4 4 4 4 4 4 4 4 4 5 5 5 4 4 7 4 4 4 4 4 4 5 5 5 4 4 4 4 4 4 4 7 4 5 5 5 4 4 4 4 4 4 4 4 4 5 5
4 4 4 4 4 4 4 4 4 4 4 4 4 4 4 7 4 6 4 4 4 4 4 4 4 4 4 4 4 4 4 4 7 4 4 4 6 4 4 4 4 4 4 4 4 4 4 4 4 4 4 4 4 4 4 6 4 4 4 4 4 4 4 4 4 4 7 4 4 4 4 4 4 4 6 4 4 4 4 4 4 4 4 7 4 4 4 4 4 4 4 4 4 6 4 4 4 4 4 4
4 4 5 5 5 4 4 4 4 4 4 4 4 4 5 5 5 4 6 4 4 4 4 4 4 4 5 5 5 4 4 7 4 4 4 4 4 6 5 5 5 4 4 4 4 4 4 4 4 4 4 4 4 4 4 4 6 4 4 4 4 4 5 5 5 7 4 4 4 4 4 4 4 4 5 5 5 4 4 4 4 4 7 4 4 4 5 5 5 4 4 4 4 4 6 4 4 4 5 5
6 4 5 5 5 4 4 4 4 4 4 4 4 7 5 5 5 4 4 6 4 4 4 4 4 4 5 5 5 4 7 4 4 4 4 4 4 4 5 5 5 4 4 4 4 4 4 4 4 4 4 4 4 4 4 4 4 6 4 4 4 4 5 5 5 4 4 4 4 4 4 4 4 4 5 5 5 4 4 4 4 7 4 4 4 4 5 5 5 4 4 4 4 4 4 6 4 4 5 5
4 4 5 5 5 4 4 4 4 4 4 4 7 4 5 5 5 4 4 4 4 4 4 4 4 4 5 5 5 7 4 4 4 4 4 4 4 4 5 5 5 4 4 4 4 4 4 4 4 4 4 4 4 4 4 4 4 4 4 4 4 4 5 5 5 4 4 4 4 4 4 4 4 4 5 5 5 4 4 4 7 4 4 4 4 4 5 5 5 4 4 4 4 4 4 4 4 7 5 5
4 4 4 4 4 4 4 4 4 4 4 7 4 4 4 4 4 4 4 4 4 4 4 4 4 4 4 4 7 4 4 4 4 4 4 4 4 4 4 4 4 4 4 4 4 4 4 4 4 4 4 4 4 4 4 4 4 4 4 4 4 4 7 4 4 4 4 4 4 4 4 4 4 4 4 4 4 4 4 7 4 4 4 4 4 4 4 4 4 4 4 4 4 4 4 4 7 4 4 4
4 4 5 5 5 4 4 4 4 4 7 4 4 4 5 5 5 4 4 4 4 4 4 4 4 4 5 5 5 4 4 4 4 4 4 4 4 4 5 5 5 4 4 4 7 4 4 4 4 4 4 4 4 4 4 4 4 4 4 4 4 7 5 5 5 4 4 4 4 4 4 4 4 4 5 5 5 4 7 4 4 4 4 4 4 4 5 5 5 4 4 4 4 4 4 7 4 4 5 5
4 4 5 5 5 4 4 4 4 7 4 4 4 4 5 5 5 4 4 4 4 4 4 6 4 4 5 5 5 4 4 4 4 4 4 4 4 4 5 5 5 4 6 7 4 4 4 4 4 4 4 4 4 4 4 4 4 4 4 4 7 6 5 5 5 4 4 4 4 4 4 4 4 4 5 5 5 7 4 4 6 4 4 4 4 4 5 5 5 4 4 4 4 4 7 4 4 4 5 5
4 4 5 5 5 6 4 4 7 4 4 4 4 4 5 5 5 4 4 4 4 4 4 4 6 7 5 5 5 4 4 4 4 4 4 4 4 4 5 5 5 4 7 6 4 4 4 4 4 4 4 4 4 4 4 4 4 4 4 7 4 4 5 5 5 4 4 4 4 4 4 4 4 4 5 5 5 4 4 4 4 6 4 4 4 4 5 5 5 4 4 4 4 7 4 4 4 4 5 5
4 4 4 4 4 4 6 7 4 4 4 4 4 4 4 4 4 4 4 4 4 4 4 4 7 6 4 4 4 4 4 4 4 4 4 4 4 4 4 4 4 7 4 4 6 4 4 4 4 4 4 4 4 4 4 4 4 4 7 4 4 4 4 6 4 4 4 4 4 4 4 4 4 4 4 7 4 4 4 4 4 4 6 4 4 4 4 4 4 4 4 4 7 4 4 4 4 4 4 4
4 4 5 5 5 4 7 4 4 4 4 4 4 4 5 5 5 4 4 4 4 4 4 7 4 4 5 5 5 4 4 4 4 4 4 4 4 4 5 5 5 4 4 4 4 4 4 4 4 4 4 4 4 4 4 4 4 7 4 4 4 4 5 5 5 4 4 4 4 4 4 4 4 4 5 5 5 4 4 4 4 4 4 4 4 4 5 5 5 4 4 7 4 4 4 4 4 4 5 5
4 4 5 5 5 7 4 4 4 4 4 4 4 4 5 5 5 4 4 4 4 4 7 4 4 4 5 5 5 4 4 4 4 4 4 4 4 4 5 5 5 4 4 4 4 4 4 4 4 4 4 4 4 4 4 4 7 4 4 4 4 4 5 5 5 4 4 4 4 4 4 4 4 7 5 5 5 4 4 4 4 4 4 4 4 4 5 5 5 4 7 4 4 4 4 4 4 4 5 5
4 4 5 5 5 4 4 4 4 4 4 4 4 4 5 5 5 4 4 4 4 7 4 4 4 4 5 5 5 4 4 4 4 4 4 4 4 4 5 5 5 4 4 4 4 4 4 4 4 4 4 4 4 4 4 7 4 4 4 4 4 4 5 5 5 4 4 4 4 4 4 4 7 4 5 5 5 4 4 4 4 4 4 4 4 4 5 5 5 7 4 4 4 4 4 4 4 4 5 5
A A A 8 8 8 A A A 8 8 8 A A A 8 8 8 A A A 8 8 8 A A A 8 8 8 A A A 8 8 8 A A A 8 8 8 A A A 4 4 4 4 4 4 4 4 4 4 A A 8 8 8 A A A 8 8 8 A A A 8 8 8 A A A 8 8 8 A A A 8 8 8 A A A 8 8 8 A A A 8 8 8 A A A 8
8 8 8 8 8 8 8 B 8 8 8 8 A 8 8 8 8 8 8 8 8 B 8 8 8 8 8 8 8 8 8 8 8 A 8 B 8 8 8 8 8 8 8 8 8 8 8 8 8 8 8 8 8 8 8 8 8 8 8 8 8 8 8 B 8 8 8 8 8 8 8 8 8 8 8 A 8 B 8 8 8 8 8 8 8 8 8 8 8 8 8 B 8 8 8 8 A 8 8 8
8 8 8 8 8 8 B 8 8 8 8 8 8 A 8 8 8 8 8 8 B 8 8 8 8 8 8 8 8 8 8 8 8 8 B 8 8 8 8 8 8 8 8 8 8 8 8 8 8 8 8 8 8 8 8 A 8 8 8 8 8 8 B 8 8 8 8 8 8 8 8 8 8 8 8 8 B 8 8 8 8 8 8 8 8 8 8 8 8 8 B 8 8 8 8 8 8 A 8 8
9 9 8 8 8 B 8 8 8 8 9 9 8 8 A 8 8 8 8 B 9 9 8 8 8 8 8 8 8 8 9 9 8 B 8 A 8 8 8 8 9 9 8 8 8 8 8 8 8 8 8 8 8 8 8 8 A 8 8 8 9 B 8 8 8 8 8 8 8 8 9 9 8 8 8 B 8 A 8 8 9 9 8 8 8 8 8 8 8 B 9 9 8 8 8 8 8 8 A 8
9 9 8 8 B 8 8 8 8 8 9 9 8 8 8 A 8 8 B 8 9 9 8 8 8 8 8 8 8 8 9 9 B 8 8 8 A 8 8 8 9 9 8 8 8 8 8 8 8 8 8 8 8 8 8 8 8 A 8 8 B 9 8 8 8 8 8 8 8 8 9 9 8 8 B 8 8 8 A 8 9 9 8 8 8 8 8 8 B 8 9 9 8 8 8 8 8 8 8 A
8 8 8 B 8 8 8 8 8 8 8 8 8 8 8 8 A B 8 8 8 8 8 8 8 8 8 8 8 8 8 B 8 8 8 8 8 A 8 8 8 8 8 8 8 8 8 8 8 8 8 8 8 8 8 8 8 8 A B 8 8 8 8 8 8 8 8 8 8 8 8 8 B 8 8 8 8 8 A 8 8 8 8 8 8 8 B 8 8 8 8 8 8 8 8 8 8 8 8
8 8 B 8 8 8 8 8 8 8 8 8 8 8 8 8 B A 8 8 8 8 8 8 8 8 8 8 8 8 B 8 8 8 8 8 8 8 A 8 8 8 8 8 B 8 8 8 8 8 8 8 8 8 8 8 8 8 B A 8 8 8 8 8 8 8 8 8 8 8 8 B 8 8 8 8 8 8 8 A 8 8 8 8 8 B 8 8 8 8 8 8 8 8 8 8 8 8 8
8 B 8 8 8 8 8 8 8 8 8 8 8 8 8 B 8 8 A 8 8 8 8 8 8 8 8 8 8 B 8 8 8 8 8 8 8 8 8 A 8 8 8 B 8 8 8 8 8 8 8 8 8 8 8 8 8 B 8 8 A 8 8 8 8 8 8 8 8 8 8 B 8 8 8 8 8 8 8 8 8 A 8 8 8 B 8 8 8 8 8 8 8 8 8 8 8 8 8 B
B 9 8 8 8 8 8 8 8 8 9 9 8 8 B 8 8 8 8 A 9 9 8 8 8 8 8 8 B 8 9 9 8 8 8 8 8 8 8 8 9 9 B 8 8 8 8 8 8 8 8 8 8 8 8 8 B 8 8 8 9 9 8 8 8 8 8 8 8 8 B 9 8 8 8 8 8 8 8 8 9 9 A 8 B 8 8 8 8 8 9 9 8 8 8 8 8 8 B 8
9 9 8 8 8 8 8 8 8 8 9 9 8 B 8 8 8 8 8 8 9 9 8 8 8 8 8 B 8 8 9 9 8 8 8 8 8 8 8 8 9 B 8 8 8 8 8 8 8 8 8 8 8 8 8 B 8 8 8 8 9 9 A 8 8 8 8 8 8 B 9 9 8 8 8 8 8 8 8 8 9 9 8 B 8 8 8 8 8 8 9 9 8 8 8 8 8 B 8 8
A 8 8 8 8 8 8 8 8 8 8 8 B 8 8 8 8 8 8 8 8 A 8 8 8 8 B 8 8 8 8 8 8 8 8 8 8 8 8 8 B 8 A 8 8 8 8 8 8 8 8 8 8 8 8 8 8 8 8 8 8 8 8 A 8 8 8 8 B 8 8 8 8 8 8 8 8 8 8 8 8 8 B 8 A 8 8 8 8 8 8 8 8 8 8 8 B 8 8 8
8 A 8 8 8 8 8 8 8 8 8 B 8 8 8 8 8 8 8 8 8 8 A 8 8 B 8 8 8 8 8 8 8 8 8 8 8 8 8 B 8 8 8 A 8 8 8 8 8 8 8 8 8 8 8 8 8 8 8 8 8 8 8 8 A 8 8 B 8 8 8 8 8 8 8 8 8 8 8 8 8 B 8 8 8 A 8 8 8 8 8 8 8 8 8 B 8 8 8 8
8 8 A 8 8 8 8 8 8 8 B 8 8 8 8 8 8 8 8 8 8 8 8 A B 8 8 8 8 8 8 8 8 8 8 8 8 8 B 8 8 8 8 8 A 8 8 8 8 8 8 8 8 8 8 8 8 8 8 8 8 8 8 8 8 A B 8 8 8 8 8 8 8 8 8 8 8 8 8 B 8 8 8 8 8 A 8 8 8 8 8 8 8 B 8 8 8 8 8
9 9 8 A 8 8 8 8 8 B 9 9 8 8 8 8 8 8 8 8 9 9 8 B A 8 8 8 8 8 9 9 8 8 8 8 8 B 8 8 9 9 8 8 8 8 8 8 8 8 8 8 8 8 8 8 8 8 8 8 9 9 8 8 8 B A 8 8 8 9 9 8 8 8 8 8 8 8 B 9 9 8 8 8 8 8 A 8 8 9 9 8 B 8 8 8 8 8 8
9 9 8 8 A 8 8 8 B 8 9 9 8 8 8 8 8 8 8 8 9 9 B 8 8 A 8 8 8 8 9 9 8 8 8 8 B 8 8 8 9 9 8 8 8 8 8 8 8 8 8 8 8 8 8 8 8 8 8 8 9 9 8 8 B 8 8 A 8 8 9 9 8 8 8 8 8 8 B 8 9 9 8 8 8 8 8 8 A 8 9 9 B 8 8 8 8 8 8 8
8 8 8 8 8 A 8 B 8 8 8 8 8 8 8 8 8 8 8 8 8 B 8 8 8 8 A 8 8 8 8 8 8 8 8 B 8 8 8 8 8 8 8 8 8 8 8 8 8 8 8 8 8 8 8 8 8 8 8 8 8 8 8 B 8 8 8 8 A 8 8 8 8 8 8 8 8 B 8 8 8 8 8 8 8 8 8 8 8 A 8 B 8 8 8 8 8 8 8 8
8 8 8 8 8 8 B 8 8 8 8 8 8 8 8 8 8 8 8 8 B 8 8 8 8 8 8 A 8 8 8 8 8 8 B 8 8 8 8 8 8 8 8 8 8 8 8 8 8 8 8 8 8 8 8 8 8 8 8 8 8 8 B 8 8 8 8 8 8 A 8 8 8 8 8 8 B 8 8 8 8 8 8 8 8 8 8 8 8 8 B 8 8 8 8 8 8 8 8 8
8 8 8 8 8 B 8 A 8 8 8 8 8 8 8 8 8 8 8 B 8 8 8 8 8 8 8 8 A 8 8 8 8 B 8 8 8 8 8 8 8 8 8 8 8 8 8 8 8 8 8 8 8 8 8 8 8 8 8 8 8 B 8 8 8 8 8 8 8 8 A 8 8 8 8 B 8 8 8 8 8 8 8 8 8 8 8 8 8 B 8 A 8 8 8 8 8 8 8 8
9 9 8 8 B 8 8 8 A 8 9 9 8 8 8 8 8 8 B 8 9 9 8 8 8 8 8 8 8 A 9 9 B 8 8 8 8 8 8 8 9 9 8 8 8 8 8 8 8 8 8 8 8 8 8 8 8 8 8 8 B 9 8 8 8 8 8 8 8 8 9 9 8 8 B 8 8 8 8 8 9 9 8 8 8 8 8 8 B 8 9 9 A 8 8 8 8 8 8 8
9 9 8 B 8 8 8 8 8 A 9 9 8 8 8 8 8 B 8 8 9 9 8 8 8 8 8 8 8 8 9 B 8 8 8 8 8 8 8 8 9 9 8 8 8 8 8 8 8 8 8 8 8 8 8 8 8 8 8 B 9 9 8 8 8 8 8 8 8 8 9 9 A B 8 8 8 8 8 8 9 9 8 8 8 8 8 B 8 8 9 9 8 A 8 8 8 8 8 8
8 8 B 8 8 8 8 8 8 8 A 8 8 8 8 8 B 8 8 8 8 8 8 8 8 8 8 8 8 8 B A 8 8 8 8 8 8 8 8 8 8 8 8 B 8 8 8 8 8 8 8 8 8 8 8 8 8 B 8 8 8 8 8 8 8 8 8 8 8 8 8 B A 8 8 8 8 8 8 8 8 8 8 8 8 B 8 8 8 8 8 8 8 A 8 8 8 8 8
8 B 8 8 8 8 8 8 8 8 8 A 8 8 8 B 8 8 8 8 8 8 8 8 8 8 8 8 8 B 8 8 A 8 8 8 8 8 8 8 8 8 8 B 8 8 8 8 8 8 8 8 8 8 8 8 8 B 8 8 8 8 8 8 8 8 8 8 8 8 8 B 8 8 A 8 8 8 8 8 8 8 8 8 8 B 8 8 8 8 8 8 8 8 8 A 8 8 8 B
B 8 8 8 8 8 8 8 8 8 8 8 A 8 B 8 8 8 8 8 8 8 8 8 8 8 8 8 B 8 8 8 8 A 8 8 8 8 8 8 8 8 B 8 8 8 8 8 8 8 8 8 8 8 8 8 B 8 8 8 8 8 8 8 8 8 8 8 8 8 B 8 8 8 8 A 8 8 8 8 8 8 8 8 B 8 8 8 8 8 8 8 8 8 8 8 A 8 B 8
9 9 8 8 8 8 8 8 8 8 9 9 8 B 8 8 8 8 8 8 9 9 8 8 8 8 8 B 8 8 9 9 8 8 A 8 8 8 8 8 9 B 8 8 8 8 8 8 8 8 8 8 8 8 8 B 8 8 8 8 9 9 8 8 8 8 8 8 8 B 9 9 8 8 8 8 A 8 8 8 9 9 8 B 8 8 8 8 8 8 9 9 8 8 8 8 8 B 8 8
9 9 8 8 8 8 8 8 8 8 9 9 B 8 A 8 8 8 8 8 9 9 8 8 8 8 B 8 8 8 9 9 8 8 8 A 8 8 8 8 B 9 8 8 8 8 8 8 8 8 8 8 8 8 8 8 A 8 8 8 9 9 8 8 8 8 8 8 B 8 9 9 8 8 8 8 8 A 8 8 9 9 B 8 8 8 8 8 8 8 9 9 8 8 8 8 B 8 A 8
A A C C A A C C A A C C A A C C A A C C A A C C A A C C A A C C A A C C A A C C A A C C A 8 8 8 8 8 8 8 8 8 8 C A A C C A A C C A A C C A A C C A A C C A A C C A A C C A A C C A A C C A A C C A A C C
C C C C C C C C C C C C C C C C D C C C C C C C C C C C C C C C C C D C C C C C C C C C C C C C C C C C C C C C C C C C C C C C C C C C C C D C C C C C C C C C C C C C C C C C D C C C C C C C C C C C
C C C C C C C C C C C C C C C D C C C C C C C C C C C C C C C C C D C C C C C C C C C C C C C C C C C C C C C C C C C C C C C C C C C C C D C C C C C C C C C C C C C C C C C D C C C C C C C C C C C C
C C C C C C C C C C C C C C D C C C C C C C C C C C C C C C C C D C C C C C C C C C C C C C C C C C C C C C C C C C C C C C C C C C C C D C C C C C C C C C C C C C C C C C D C C C C C C C C C C C C C
C C C C C E E C C C C C C D C C C C E E C C C C C C C C C C C D E C C C C C C C C C C C E C C C C C C C C C C C C E E C C C C C C C C D C C E E C C C C C C C C C C C E E D C C C C C C C C C C E E C C
C C C C C C C C C C C C D C C C C C C C C C C C C C C C C C D C C C C C C C C C C C C C C C C C C C C C C C C C C C C C F G G G H H H H C C C C C C C C C C C C C C C C D C C C C C C C C C C C C C C C
C C C C C C C C C C C D C C C C C C C C C C C C C C C C C D C C C C C C C C C C C C C C C C C C C C C C C C C C C C C C I J J J I J J I C C C C C C C C C C C C C C C D C C C C C C C C C C C C C C C C
C C C C C C C C C C D C C C C C C C C C C C C C C C C C D C C C C C C C C C C C C C C C C C C C C C C C C C C C C C C C I J K J I J K I C C C C C C C C C C C C C C D C C C C C C C C C C C C C C C C C
C C C C C C C C C D C C C C C C C C C C C C C C C C C D C C C C C C C C C C C C C C C C C C C C C C C C C C C C C C C C I J J J I J J I C C C C C C C C C C C C C D C C C C C C C C C C C C C C C C C D
C C C C C C C C D C C C C C C C C C C C C C C C C C D C C C C C C C C C C C C C C C C C D C C C C C C C C C C C C C C C F G G G H H H H C C C C C C C C C C C C D C C C C C C C C C C C C C C C C C D C
C C C C C C C D C C C C C C C C C C C C C C C C C D C C C C C C C C C C C C C C C C C D C C C C C C C C C C C C C C C C C D C C C C C C C C C C C C C C C C C D C C C C C C C C C C C C C C C C C D C C
C C C C C E D C C C C C C C C C C C E E C C C C D C C C C C C E E C C C C C C C C C D C E C C C C C C C C C C C C E E C D C C C C C C C C C E E C C C C C C D C C C C E E C C C C C C C C C C C D E C C
C C C C C D C C C C C C C C C C C C C C C C C D C C C C C C C C C C C C C C C C C D C C C C C C C C C C C C C C C C C D C C C C C C C C C C C C C C C C C D C C C C C C C C C C C C C C C C C D C C C C
C C C C D C C C C C C C C C C C C C C C C C D C C C C C C C C C C C C C C C C C D C C C C C C C C C C C C C C C C C D C C C C C C C C C C C C C C C C C D C C C C C C C C C C C C C C C C C D C C C C C
C C C D C C C C C C C C C C C C C C C C C D C C C C C C C C C C C C C C C C C D C C C C C C C C C C C C C C C C C D C C C C C C C C C C C C C C C C C D C C C C C C C C C C C C C C C C C D C C C C C C
C C D C C C C C C C C C C C C C C C C C D C C C C C C C C C C C C C C C C C D C C C C C C C C C C C C C C C C C D C C C C C C C C C C C C C C C C C D C C C C C C C C C C C C C C C C C D C C C C C C C
C D C C C C C C C C C C C C C C C C C D C C C C C C C C C C C C C C C C C D C C C C C C C C C C C C C C C C C D C C C C C C C C C C C C C C C C C D C C C C C C C C C C C C C C C C C D C C C C C C C C
D C C C C C C C C C C C C C C C C C D C C C C C C C C C C C C C C C C C D C C C C C C C C C C C C C C C C C C C C C C C C C C C C C C C C C C C D C C C C C C C C C C C C C C C C C D C C C C C C C C C
C C C C C E E C C C C C C C C C C D E E C C C C C C C C C C C E E C C D C C C C C C C C E C C C C C C C C C C C C E E C C C C C C C C C C C E D C C C C C C C C C C C E E C C C C D C C C C C C E E C C
C C C C C C C C C C C C C C C C D C C C C C C C C C C C C C C C C C D C C C C C C C C C C C C C C C C C C C C C C C C C C C C C C C C C C C D C C C C C C C C C C C C C C C C C D C C C C C C C C C C C
C C C C C C C C C C C C C C C D C C C C C C C C C C C C C C C C C D C C C C C C C C C C C C C C C C C C C C C C C C C C C C C C C C C C C D C C C C C C C C C C C C C C C C C D C C C C C C C C C C C C
C C C C C C C C C C C C C C D C C C C C C C C C C C C C C C C C D C C C C C C C C C C C C C C C C C C C C C C C C C C C C C C C C C C C D C C C C C C C C C C C C C C C C C D C C C C C C C C C C C C C
C C C C C C C C C C C C C D C C C C C C C C C C C C C C C C C D C C C C C C C C C C C C C C C C C C C C C C C C C C C C C C C C C C C D C C C C C C C C C C C C C C C C C D C C C C C C C C C C C C C C
C C C C C C C C C C C C D C C C C C C C C C C C C C C C C C D C C C C C C C C C C C C C C C C C C C C C C C C C C C C C C C C C C C D C C C C C C C C C C C C C C C C C D C C C C C C C C C C C C C C C
C C C C C C C C C C C D C C C C C C C C C C C C C C C C C D C C C C C C C C C C C C C C C C C C C C C C C C C C C C C C C C C C C D C C C C C C C C C C C C C C C C C D C C C C C C C C C C C C C C C C
C C C C C E E C C C D C C C C C C C E E C C C C C C C C D C C E E C C C C C C C C C C C E C C C C C C C C C C C C E E C C C C C D C C C C C E E C C C C C C C C C C D E E C C C C C C C C C C C E E C C
C C C C C C C C C D C C C C C C C C C C C C C C C C C D C C C C C C C C C C C C C C C C C C C C C C C C C C C C C C C C C C C D C C C C C C C C C C C C C C C C C D C C C C C C C C C C C C C C C C C D
R 12 60 1 1
R 20 80 1 1
R 26 35 1 1
R 28 55 1 1
R 40 25 2 1
R 42 65 2 1
R 52 30 2 1
R 59 80 2 1
R 60 50 2 1
R 73 20 3 1
R 78 45 3 1
R 82 70 3 1
R 89 35 3 1
R 92 85 3 1
