100 100
C C C C C C C C C C C C 2 C C C C C C C C C C C C C C C C C C C C C C C C C C 2 C C C C C C C C C C C C C C C C C C 4 C C C C C C C C 4 C C 4 C C 4 4 6 4 C C C C 4 4 C C C C C C C C C C C C C C C C C
C C C C C C C C C C C C C C C C C C C C C C 2 2 C C C C C C C C C C C C C C C C C C C C C C C C C C C C C C C C C C C 4 C 4 C 4 4 C 4 4 C C 4 4 4 C 4 4 C C C 4 4 C 4 4 4 C C C C C C C C C C C C C C C
C C 2 C C C C C C C C C C C C C C C C C C 2 C C C C C C C C C C C C C C C C C C C C C C C C C C C C C C C C C C C C C C C C 4 4 4 4 6 4 4 4 4 4 6 4 6 4 4 4 4 4 4 4 4 C C 4 C C C 4 C C C C C C C C C C
C C C C C C C 2 C C C C C C C C C C C C 2 C C 2 C C 2 0 2 C 2 C C C C 2 C C 2 C C C C C C C C C C C C C C C C C 6 C 4 4 4 4 4 6 4 4 4 4 4 4 4 4 4 4 6 6 4 4 4 4 4 4 4 4 4 4 6 C 4 C C C C C C C C C C C
C C C C C C 2 C C C C C C C C C C C 2 C C C C 0 C 0 0 0 2 0 C C C 0 C C C 2 C C C C C C C C C C C C C C C C C 4 C 4 4 4 4 4 4 4 4 4 6 4 4 4 4 4 4 6 6 6 6 4 4 6 4 4 4 4 4 4 C 4 C C 6 C C C C C C C C C
C C C 2 C C C C C C C C 2 C C 0 2 0 0 0 0 C 2 C C 2 C 0 C C 0 0 C 2 0 0 C 2 C C C C C C C C C C C C C 6 C C C 4 C 4 4 4 4 4 4 4 6 6 6 6 6 4 4 4 6 6 6 5 6 6 4 4 4 4 4 4 4 4 4 4 4 4 C C C C C C C C C C
C C C C C C C C C C 2 C C 2 C C 0 2 0 0 2 0 2 C 2 0 0 0 0 C 2 0 C C C 0 0 C C C C C C C C C C C C C C C 4 6 4 4 6 4 4 4 4 4 4 6 5 5 5 5 5 6 6 6 6 6 6 6 6 4 6 7 4 4 4 6 4 4 4 6 4 C 4 C C C C C C C C C
C C C C C C C C C 0 C 0 0 C C 0 C 0 0 0 C 2 2 0 0 2 2 0 0 2 0 2 0 0 2 C 0 2 C C 2 C C C C C C C C C 4 C 4 C 4 4 4 C 4 4 4 4 4 6 5 5 5 5 5 6 5 5 5 5 5 6 6 6 6 6 6 4 4 4 4 6 4 4 4 6 C 4 4 6 4 C C C C C
C C C C C C C C C C C C 0 2 2 0 C 0 0 0 0 0 2 0 0 1 2 0 0 2 0 0 C 0 0 0 2 2 0 0 C C C C C C C C C C C C C 4 4 4 4 4 4 4 4 4 6 6 5 5 5 5 5 6 6 5 5 5 5 6 6 6 5 5 6 4 4 6 6 6 6 6 4 4 4 4 6 6 6 C 4 C C C
C C C C C C C C 0 C 0 0 0 2 2 0 2 0 2 0 0 2 2 2 2 0 0 0 2 0 0 2 0 0 0 2 2 C 0 C 2 C 0 C C 0 C C C C C 4 C C 6 4 4 4 4 6 6 4 6 6 5 5 5 5 5 6 5 5 5 5 5 6 6 6 6 6 6 6 6 5 5 5 5 5 6 4 4 6 6 5 6 6 C C C C
C C C C C C C C 0 C 2 C 0 0 0 0 0 2 1 0 0 0 2 2 2 0 0 2 0 0 0 0 0 0 0 2 0 3 0 2 0 0 2 C 2 C C C C C 4 4 4 4 4 4 4 4 4 4 7 6 6 6 5 5 5 5 5 6 5 5 5 5 5 6 5 5 5 5 6 4 6 5 5 5 5 5 6 6 4 4 6 6 6 4 C 4 C C
C C C C C 0 C C C 0 0 C D 2 2 0 0 0 0 3 0 0 0 3 0 0 0 2 0 0 0 0 2 1 0 0 0 0 0 0 2 0 2 C C C C 4 4 C C C 4 4 4 4 4 4 6 4 6 6 6 5 6 6 6 6 6 6 5 5 5 5 5 6 5 5 5 5 6 6 6 5 5 5 5 5 6 6 4 4 4 6 4 4 4 C C 4
C C C C C 0 C C 2 C 0 3 0 2 0 0 0 2 0 0 0 1 1 0 0 0 0 2 0 2 1 3 0 0 0 2 0 0 0 0 0 3 0 C C C C C C C 4 4 4 4 4 4 4 4 4 6 6 5 6 6 5 5 6 5 6 6 6 6 6 6 6 5 5 5 5 5 6 6 6 5 5 5 5 5 6 4 4 6 4 4 4 C 4 4 6 C
C C C C 0 0 C C 0 2 0 0 0 0 0 0 0 0 2 0 0 0 0 0 3 0 3 0 1 0 2 1 0 0 0 0 0 2 0 0 3 0 0 C C 0 0 C 4 4 4 4 4 4 4 4 4 7 6 4 6 6 6 6 6 6 6 6 6 6 6 4 6 6 6 5 5 5 5 5 6 4 6 5 5 5 5 5 6 4 4 4 4 4 4 4 6 C C C
C C C C C 0 2 2 C 0 0 0 0 0 0 0 0 0 1 0 2 0 0 0 0 1 0 0 0 1 3 0 0 0 0 2 2 3 0 0 0 0 0 3 2 C C 0 4 C 4 4 4 4 4 4 6 6 6 6 6 6 6 5 5 6 5 5 6 5 6 6 4 5 6 5 5 5 5 5 6 5 5 6 6 6 6 6 4 4 4 6 4 4 4 C C 4 C C
C C C C C C 2 0 2 0 0 2 2 0 0 2 0 2 0 0 0 2 0 2 0 0 2 2 2 0 0 3 0 2 0 0 0 1 1 0 0 2 0 2 2 C 4 C 0 C 4 4 4 4 4 6 5 5 6 5 5 6 6 6 6 5 5 5 6 6 6 4 5 6 6 6 6 6 6 6 4 5 4 4 4 6 4 4 4 4 4 4 4 4 4 4 4 C C 4
C 0 C C 2 2 2 0 0 0 2 0 2 0 1 0 3 0 0 2 2 3 0 0 2 0 0 0 0 1 0 2 0 0 2 1 2 3 2 0 1 2 0 2 2 0 C C 0 C 4 4 4 4 4 6 5 6 6 6 5 6 6 6 6 6 5 5 6 6 6 4 4 4 7 6 6 6 6 6 6 4 4 4 4 4 4 4 4 5 6 4 4 4 4 4 4 4 C 4
C 0 C C 0 0 0 2 2 2 2 3 0 0 1 0 0 0 0 0 0 3 0 2 0 0 0 2 1 2 0 2 0 0 1 2 0 0 2 0 0 0 0 3 2 0 C 2 C C 4 4 7 4 6 6 6 6 5 6 6 6 6 5 5 6 5 5 6 6 6 6 6 5 4 6 5 5 5 6 4 4 4 4 4 4 4 4 6 6 6 6 6 4 4 4 4 4 4 4
C C 2 2 C 2 0 2 0 2 0 3 3 0 2 0 0 0 2 1 0 2 0 0 2 1 0 0 0 2 0 0 3 0 3 0 2 0 0 3 0 1 0 0 0 C C 4 C 4 4 4 4 4 4 6 5 6 6 6 5 6 5 5 5 6 6 6 5 5 6 5 5 6 6 6 5 5 5 6 6 6 4 C C C C 6 6 6 6 6 6 6 4 4 4 C C C
C C C 0 0 0 2 0 0 0 2 1 0 2 1 2 1 2 2 2 0 0 2 0 1 2 0 0 0 0 2 0 2 0 0 0 0 0 0 0 0 0 2 0 C C C C 4 4 4 4 5 4 4 6 5 5 6 5 5 6 5 5 5 6 6 6 6 6 6 6 6 6 5 6 5 5 5 6 6 4 C C C C C 6 6 5 5 5 6 6 4 4 4 4 4 C
C C 0 0 2 0 2 2 2 0 2 0 2 0 0 0 0 1 0 0 0 0 0 0 0 2 0 0 2 0 0 1 0 2 3 0 2 0 0 1 0 1 2 0 0 2 C C C 4 4 4 4 4 6 6 6 6 6 6 6 6 6 6 6 6 6 6 6 5 5 5 6 6 6 6 6 6 6 6 6 6 C C C C 6 6 6 5 5 5 6 6 6 4 4 6 C C
C 0 C 0 2 0 0 2 0 0 0 0 0 1 0 0 3 2 0 0 1 0 1 0 0 0 0 1 0 2 0 1 0 0 0 0 2 0 2 0 0 0 2 0 0 0 0 0 0 4 4 4 4 6 6 6 6 6 6 4 4 4 5 6 5 5 5 6 6 5 5 5 6 6 4 4 6 6 6 6 5 6 6 C C C 6 5 6 5 5 5 6 5 5 6 4 4 4 C
C 0 0 C 0 2 2 2 0 0 1 0 0 0 0 0 2 3 0 0 1 3 3 1 0 0 1 2 0 0 0 0 1 0 0 1 0 2 2 0 3 0 3 2 0 0 0 C C C 4 4 4 6 5 5 5 6 4 4 4 4 6 6 5 5 5 6 6 5 5 5 6 6 6 6 6 6 6 6 6 6 C C C 6 6 5 6 6 6 6 6 6 5 6 4 4 C C
C 0 2 2 0 2 0 2 2 2 2 2 0 0 0 0 0 2 0 0 0 1 2 0 0 0 0 1 0 0 3 0 0 0 0 1 1 0 0 0 1 3 2 0 0 2 0 C C C 4 4 6 6 5 5 5 6 6 5 4 4 4 6 5 5 5 6 6 6 6 6 6 6 6 5 5 5 6 6 6 C C C C C 6 5 5 5 6 5 6 5 5 6 6 4 4 4
C 2 2 2 0 0 2 0 0 1 0 0 0 0 0 0 1 0 0 0 2 0 1 1 0 0 0 1 0 1 0 0 3 0 0 1 0 0 0 2 3 2 0 0 2 0 0 C 0 C 4 4 4 6 5 5 6 6 4 6 4 5 5 6 6 6 6 6 5 4 6 4 6 6 6 6 5 6 6 5 6 6 C C C C 6 5 5 5 5 5 6 5 5 6 4 4 4 4
2 2 0 0 0 2 1 0 0 0 3 0 2 0 2 0 0 2 0 0 0 0 0 0 3 0 0 0 0 0 2 0 1 0 0 0 2 0 3 2 0 0 0 2 1 C C C C C 4 4 4 6 6 6 6 6 6 6 6 6 7 4 5 6 4 4 5 4 4 6 4 5 6 6 6 5 6 6 6 C C C C 4 6 6 6 6 6 6 5 5 5 6 4 4 4 6
0 2 0 0 0 0 0 0 0 0 0 1 0 2 2 0 0 2 1 3 1 2 0 0 2 1 2 2 2 3 0 0 0 0 0 0 0 2 0 2 2 0 0 0 2 0 C C C 4 4 4 4 5 6 6 5 6 6 5 5 6 4 5 5 7 4 6 5 6 6 6 6 6 6 5 6 6 6 6 C C C C C 4 5 6 5 6 6 6 6 6 6 4 4 4 4 C
0 0 2 2 2 0 2 0 0 0 1 0 0 0 3 2 0 1 0 0 0 0 1 0 0 0 0 0 0 0 0 1 1 2 0 0 0 0 0 0 0 2 0 3 2 0 C 4 C 4 6 4 4 7 4 6 6 6 5 5 5 6 6 4 6 4 4 4 5 6 5 6 6 6 6 6 6 C C C C C C C 5 4 4 6 5 5 5 5 6 6 7 4 4 4 4 C
0 0 2 2 0 1 0 1 0 0 0 2 2 1 3 0 2 0 2 1 0 0 0 0 2 0 0 2 1 0 3 0 1 2 2 2 0 0 0 0 1 0 0 1 0 2 C C C C C C C C 4 4 6 6 5 5 5 6 4 4 4 4 4 5 6 6 6 5 5 5 5 6 6 C C C C C C 4 4 6 5 4 6 6 6 6 6 4 4 4 4 4 4 4
0 0 0 0 0 0 0 0 0 0 0 0 1 0 2 0 1 0 0 2 1 0 0 0 0 0 2 0 0 1 2 0 0 0 0 0 2 0 0 1 3 2 0 0 0 2 C C C C C C C C 4 4 7 6 6 6 6 6 4 4 4 4 7 4 5 6 6 5 5 5 5 5 6 C C C C C 5 4 4 5 5 4 4 5 6 4 4 4 4 4 4 4 4 4
0 2 0 2 0 0 0 1 0 2 0 3 0 0 0 0 0 1 2 0 2 0 0 0 0 0 0 1 0 0 2 0 0 2 0 0 0 2 3 0 0 0 0 0 1 C C C F G G H C C 4 4 4 7 5 6 6 4 4 4 4 4 4 4 5 6 6 5 5 5 5 5 6 6 C C C 4 4 4 6 5 4 4 4 4 4 4 4 4 4 6 4 4 4 4
0 0 0 0 0 0 0 2 2 0 3 0 0 0 0 0 0 0 0 2 3 0 0 0 0 0 0 2 0 2 0 0 0 0 2 2 1 0 0 0 0 2 0 1 0 0 C C I J J I C C 4 4 4 4 4 6 6 6 4 4 4 5 4 6 6 6 6 6 5 5 5 5 6 C C C 4 4 6 6 6 6 6 4 5 5 5 4 4 4 4 4 4 4 4 4
0 2 0 0 0 0 0 0 1 0 1 0 0 0 0 2 0 0 2 0 0 0 0 C C C C C C 2 0 0 0 1 0 2 2 2 0 0 0 1 0 0 0 0 C C I K J I C C 4 6 4 4 6 6 5 6 6 5 5 7 6 5 5 5 5 5 6 5 5 5 6 C C 4 4 6 5 5 5 5 5 6 4 4 5 4 4 4 4 4 4 4 4 4
0 0 0 0 2 0 0 0 2 0 0 0 0 0 2 2 0 0 0 0 2 2 2 C C C 2 2 C C C 1 2 3 0 0 0 1 0 0 0 0 0 2 0 C C C C C C C C C 5 4 4 5 4 6 6 6 4 4 4 5 6 5 5 5 5 5 6 6 6 6 C C 4 4 5 6 5 5 5 6 6 6 6 6 4 5 4 4 4 4 4 4 4 6
2 0 0 0 0 2 0 1 0 0 0 0 0 0 0 0 0 0 0 1 0 0 2 C C C C C C C 2 C 0 1 0 0 0 2 0 3 0 1 0 0 0 0 C C C C C C C C 4 4 4 4 6 4 6 4 4 4 4 6 6 5 5 5 5 5 6 6 C C C C 5 5 6 6 5 5 6 5 5 5 5 5 6 4 4 4 4 4 4 4 4 C
0 2 0 2 0 2 2 0 0 2 0 1 2 0 0 2 1 2 2 1 0 0 3 C C C C C C 2 C C C C 0 2 2 0 1 2 2 0 2 0 0 0 C C 4 4 0 4 4 6 4 4 6 6 6 6 6 4 4 4 C C 6 5 5 5 5 5 6 C 6 C C 7 4 4 4 6 5 5 6 5 5 5 5 5 6 4 4 4 4 4 4 4 6 4
2 2 2 0 0 0 1 0 0 0 1 2 0 0 2 0 2 0 0 0 3 2 2 C C C C C C C 3 C C C C C 3 1 0 0 0 0 0 0 0 0 2 0 2 0 C C 4 4 4 6 6 6 6 5 5 6 4 C C C 6 5 5 5 5 5 6 6 6 6 6 4 7 6 4 6 5 6 6 5 5 5 5 5 6 6 4 6 6 4 4 4 4 C
0 2 0 0 0 0 0 0 1 0 1 2 0 1 2 2 2 0 3 0 0 0 2 C C C C C C C C C C C 2 C C 2 0 2 0 0 0 0 0 0 2 0 0 C C C 4 7 4 6 6 5 6 6 5 6 C 6 C C C 6 6 6 6 6 6 5 6 6 6 4 4 4 4 4 6 6 6 5 5 5 5 5 6 6 6 4 6 4 4 4 4 4
0 0 0 0 2 0 0 2 0 0 0 0 3 2 2 0 0 2 1 2 0 2 C C C C C C C C C C C C C C C C C 3 0 2 1 0 0 0 0 C C C C C 4 4 6 6 6 6 6 6 6 6 6 6 6 6 C C C 6 6 6 6 6 6 5 6 6 5 4 5 6 4 4 6 5 5 5 6 5 6 5 6 6 4 4 4 4 4 4
2 0 2 0 0 0 1 0 0 0 0 2 1 0 0 0 0 2 0 1 3 C C C C C C C C C C C C C C C C C C C C 2 0 0 0 0 0 C C C C 4 4 6 4 6 5 6 5 6 6 6 5 5 5 6 C C 6 5 5 5 5 5 6 6 6 4 4 4 6 6 6 4 5 6 6 6 6 6 6 6 6 4 4 6 4 4 4 C
0 0 0 0 1 0 2 2 2 0 0 0 1 1 2 0 0 0 0 2 2 C C C C C C C C C C C C C C C C C C C C C 2 2 0 C C C 0 2 C 4 C C 4 6 5 5 6 6 6 6 5 5 5 6 6 C 6 5 5 5 5 5 6 6 6 4 4 6 6 5 6 6 5 6 5 5 5 5 5 6 4 4 6 C 4 4 4 4
0 C 0 2 0 0 0 0 0 2 2 0 2 0 0 0 0 2 0 3 C C 2 C C 2 C 0 0 C C C 2 C C C 2 C C C C C C C 0 0 C 4 0 C 4 C A C 4 6 6 6 6 6 5 6 5 5 5 6 6 6 6 5 5 5 5 5 6 6 7 4 4 4 6 6 6 7 4 6 5 5 5 5 5 6 6 6 6 6 6 4 4 C
C C D 2 0 2 0 0 2 0 2 0 0 2 3 0 0 1 0 2 C C C C C C C 0 0 0 2 2 C C C C C C C C C C C C C C C C C C C 4 A 4 6 6 6 5 6 6 6 6 6 6 6 6 5 6 6 5 5 5 5 5 6 4 5 4 5 4 7 6 7 4 6 6 5 5 5 5 5 6 6 5 5 5 5 6 C C
C 0 0 0 0 0 2 2 0 0 0 0 2 2 0 0 0 0 0 C C C C C C C 0 0 0 0 0 0 C C C C C C C C C C C C C C C C C C C C C 6 6 5 6 6 5 6 6 6 C 6 C 6 6 6 6 5 5 5 5 5 6 C 4 C C 4 5 5 4 4 6 6 5 5 5 5 5 6 5 5 5 5 5 6 C C
0 0 2 2 0 0 0 0 2 0 0 0 0 2 0 0 0 0 1 C C C C C C C 2 0 2 0 0 0 0 2 C C C C C C C C C C F G G H C C C C C C 6 6 6 5 5 6 C C C C C A 6 9 A 6 6 6 6 6 C A C A 4 C 4 4 4 4 4 6 5 5 5 5 5 6 5 5 5 5 5 6 6 C
C C 2 C 2 0 0 0 2 0 0 0 0 3 2 0 1 2 C C C C C C C 2 2 3 2 0 0 1 0 0 0 2 C C C C C C C C I J J I C C C C C C C 6 6 6 6 6 C C C A A A A A A A A 6 C C C 9 A C C 6 4 4 4 4 6 6 6 6 6 6 6 6 5 5 5 5 5 6 C C
C 2 C C 2 0 2 0 0 0 0 0 0 0 2 2 0 1 C C C C C C C 0 1 2 0 0 0 0 0 0 0 2 0 C C C C C C C I K J I C C C C C C C C C 6 C C C C 9 A A A A A A 9 A A C C C A A C C C C 4 4 6 4 4 6 6 6 6 6 6 5 5 5 5 5 6 C C
C C C 0 2 C 0 0 0 0 2 0 2 0 2 0 0 E C C C C C C 0 2 2 2 0 0 0 0 0 2 0 0 2 2 0 C C C C C C C C C C C C C C C C C C C C C C 9 A B A A A A A A A A A A A C C C C C C 9 7 4 6 4 4 4 6 4 4 C 6 6 6 6 6 C C C
C C 0 0 2 C 0 2 0 0 0 0 0 1 2 0 0 C C C C C C C 0 0 2 2 0 0 0 0 0 0 3 0 0 0 0 3 C C C C C C C C C C C C C C C C C C C C A A A A A A 9 A A A 9 9 A 9 A A A C 4 A A A 4 4 4 4 4 4 4 4 4 6 C C 6 C C C C C
C C C 0 C C 0 0 0 0 1 0 2 1 0 2 2 C 2 C C C C 0 3 0 0 0 0 0 3 0 0 2 2 3 2 0 2 0 C C C C C C C C C C C C C C C C C C C C A A A A 9 A A A A A A A A A A A A A C C 9 C 4 C 4 4 4 4 4 4 4 C C C C C C C C C
C C C C C 2 0 0 2 0 0 0 2 1 0 2 C C C C C C C 1 0 0 0 0 0 0 2 2 0 0 0 2 0 0 2 2 C C C C C C C C C C C C C C C F G H C C A 9 B A A 9 9 A A A 9 A A A A A A A A C 4 9 C C 4 C C C 4 4 4 4 C C C C C C C C
C C C 0 C C C 0 0 0 0 2 2 2 0 0 C C 2 C C C 0 0 0 0 1 0 1 3 0 1 1 0 0 0 0 0 2 3 C 0 0 C C C C C C C C C C C C I J I C C 9 8 A A A B A A A A A A A A 9 A A 9 A A C C A A C C C 4 C C 4 4 C 6 C C C C C C
C C C C C C 0 0 C 2 0 2 0 0 2 3 C C C C C C 3 0 2 2 2 2 0 0 1 0 3 0 3 0 0 2 2 2 0 C 0 C C C C C C C C C C C C I K I C C A 9 B 8 A 9 B 9 C C C C C C C C A A A A A C 4 C C C C 4 C 4 C 4 C C C C C C C C
C C C C 2 0 C C 0 2 2 0 2 0 0 0 C C C C C 3 0 0 0 2 0 0 0 2 0 2 C C C 2 C C A 3 C 0 C 0 C C C C C C C C C C C C C C C C A 8 A A A A A A C C C C C C C C A 9 A A A A C C C C C C 4 C C 4 C C C C C C C C
2 C C C C 0 0 C C 2 C 0 0 0 2 2 C C E C C 2 2 2 0 1 0 0 0 0 2 C A 1 0 C A 2 C 0 C C C C C C C C C C C C C C C C C C C C 8 8 8 B 8 A B 9 C C F G G H C C A B A A A A A C C A C C C C C C C C C C C C C C
C C C C C C C C C C 0 0 C 0 2 0 2 2 0 0 0 3 0 2 0 0 0 0 0 0 1 C C 2 C 9 C C C 9 C A A A C C C C C C C C C C C C 8 C B A B 8 8 9 8 8 B 8 C C I J J I C C A A A A 9 9 9 A C 4 A C 9 C C C C C C C C C C C
C C C C C C C C C C C 0 2 C C 0 0 0 0 C 2 0 0 0 2 0 0 0 0 2 0 C 2 C 2 C C A 2 3 C B A A C C C C 8 8 C C C C 8 C C C 8 8 B A A 9 A A B 8 C C I K J I C C 9 9 9 A B 9 B A A C C C C C C C C C C C C C C C
C C C C C C C C C 0 C C C C 0 0 0 C 0 2 0 3 0 0 0 0 2 0 0 2 2 C A 9 0 C C A A 9 C A A A A A 9 8 8 C C 8 C C 9 C C C C A A 9 A A A A A B C C C C C C C C 9 9 9 9 B B 9 A A 9 C A C C C C C C C C C C C C
C C C C C C C C C C C C C C C C 2 C E C E C 0 2 0 C 0 C 2 0 0 A C C C A A A 9 B A A A A A 9 C C C 8 8 C C C C 8 C C C 8 8 A A A 8 A 8 A C C C C C C C C B 9 9 9 9 9 A A A A A A C C C A C C C C C C C C
C C C C C C C C C C C C C C 0 0 C 3 C 0 0 2 3 0 0 2 0 0 0 C 2 2 A A A A A A A A A A A A A A C C C 8 C C C C C C C C C A A 9 A A A 9 A A 8 A A A 8 A A 9 9 9 9 9 9 9 A A 9 9 9 8 8 A C C C C 8 C C C C C
C C C C C C C C C C C C C C C C C C C C C 0 C C 2 C C C C C C C C C A A 9 A A A 9 9 9 A A A C C C C C B C C C C C C C C A A A A 8 9 9 9 8 8 A 8 A 9 9 9 9 9 A A A A 9 A 9 9 9 9 9 C 9 C C 8 8 C C C C C
C C C C C C C C C C C C 8 C C C C C C 0 2 C C 0 C C 0 0 0 C C C C 9 A A A A A A 9 9 9 A A C C 8 C C C C C 8 C 9 C 8 C C 9 A 9 9 9 B 9 9 9 B 9 9 9 9 9 9 B 9 A A 9 A 9 A 9 9 9 9 9 9 9 C A C C C C C C C
C C C 8 C C 8 C C C C C C C C 8 C C C C C C 0 C C C C C 2 C C C C 9 A A A A 9 A 9 9 9 A A C C C C C C C C C C 8 C C 8 C C C C C C C C B A A 9 9 9 9 9 9 9 A A 9 B A A 9 A B A A 9 9 8 8 C C C C C C C C
C C C C C C C C 8 C C C C C C C C C C C C C C C C C C C 8 C C C A A A A A A A A A A B A 9 C C C C C C 8 C C 8 8 9 C C C C C C C C C C 8 9 8 9 9 9 A 9 9 9 A B A A B A A A 9 9 9 A C C C C C C C C C C C
C C C C C C C C C C C 8 C C C C C C C C C C C C C C C C C 8 9 A A A A A A A A A A A 9 9 C C C C C C C 9 C C C C C C C C C C F G H C C 8 9 9 9 A A 8 9 9 9 9 8 9 B A A 9 A 9 9 9 A 9 C C C C C C C C 8 C
C C C C C C C C C C C C C C C C C C C C C C C C C C C C A A A A A A A A A A A A A A 9 9 C C C C C C 9 A C C C 9 C C C C C C I J I C C 8 9 9 9 8 A 8 B A B A A A A B A A A 9 9 9 A A A A C C C C C C C C
C C C C C C C C C C C C C C C C C C C C C C C C C C C C C C A C 9 A A A C C C C C C C C 8 C C C C C A A A C 8 9 C C C C C C I K I C C A 9 9 9 A 9 9 A A A A 9 9 9 A A A A 9 9 9 A A C C A 8 C C C C C C
C C C C C C C C C C C C C C C C C C C C C C C C C C 8 C C C C A A 9 A A C C C C C C C C C C C 8 C C B A 8 C 9 9 C C C C C C C C C C C 8 8 A A B A 9 B 8 A A 9 9 9 9 A A A A A A A A A C C A C C C C C C
C C C C C C C C C 8 8 C C C C C C C C C C C C C C C 8 C C C 9 A 9 A A A C C F G H C C 9 C C C C C A 9 B A 8 C C 8 C C C C C C C C C C 8 B A A A 8 8 A A 9 A 9 9 9 9 A B A A A A A A C A C C C C C C C C
8 C C 8 C C C C C 8 C C C C C C C C C C C C C C C C 8 C C C C A A A A A C C I J I C C C C C C C C A 8 A 9 A C C C 8 C C C 9 C C A 9 A 8 A A A A A A A 9 B 9 A 9 A A B B A A A A 9 A A C 8 C C C C C C C
C C C C C C C C 8 C C C C C C C 8 C C C C C C C C C C C C C A A A A A A C C I K I C C 8 C C C C A 8 B A 8 A A C C C C C C C C C A 8 8 8 A 9 9 8 B A A 9 B B A A A A A A A A A B A B A C A 8 C C C C C C
C C C C C C C C C C C C C C C C C C C C C C C C C C C C A C A A A A A A C C C C C C C C C C C C A 8 8 B A 8 8 C C C C C 8 8 C C C A 9 B 9 B 9 A 8 A 8 A 9 B B 9 9 9 B B A 9 A B B C A C A C C C C C C 8
C C C C C C C C C C C C C C C C C C C C C C C C C C C A A A A A A 9 A 9 C C C C C C C C C C C C B A A A 9 9 9 8 C C C C C C 8 C C 9 9 A 9 B 9 B B A 8 B 9 9 9 9 9 9 A A A A A 9 9 9 A 9 C C C C C C C C
C C C C C C 8 C C C C C C C C C C C C C C C C C C C C C A 8 C A A A A A A A A A 8 C C C C C C B 8 9 8 9 9 9 B A C C C C C 8 C C C 8 9 9 9 B 9 9 B 8 A A 9 9 9 9 9 9 A 9 A A 9 9 B 9 C 9 C C C C C C C C
8 C C C C 8 8 C C C C C C C 8 C C C C C 8 C C C C C C C 9 C A A 9 9 A A A A A A 8 C C C C C C B A A A A 9 9 9 8 A C C C C C C C C C C 9 9 9 9 B 9 B A 8 9 9 9 8 B A A A A A B 9 9 9 A A C C C C C C C C
C C 8 C C C C C C C C C C C C C 8 C C C C C C C C C C C C A C C A A A A A A A A C C C C C C A 8 A A B A B B A 8 A C C C C C C C C C 8 9 9 9 9 B 9 A B A 8 A A 9 9 9 A A B A 9 9 9 9 A A A C 8 C C C C C
C C C C C C C C 8 C C C C C C C C C C C C C C 8 C 8 C C C C 9 A A A A A A A A A C C C C C C A A 8 A 9 A 8 A A 9 8 A A C 8 C 8 C C C C C 9 9 9 9 9 8 8 A 8 9 A 9 9 9 A A A A 9 9 9 A A 9 C C C C C C 8 C
C C C C C C C C C C C C C C 8 C C C C C C C C C C C C C C 9 C A A A A A A A 9 C C C C C 8 C 8 9 8 8 8 8 B 8 A 8 A 9 8 8 C C C C C C C C C 9 9 9 B 8 A A 8 A 9 9 9 9 9 A A B B 9 9 B A A A C C C C C C C
C C C C C C C C C 8 C C C C C C C C C C C C C C C C C C A C C A A A A A A A 9 8 C C C C C A A 8 A A 8 A A 9 A 8 9 A A B C 8 C C 8 C C C C C B B 9 A A 8 B B B 9 9 A A A B A A A 9 A A A A C C C C C C C
C C C C C C C C C C C C C C C C C C C C C C C 8 C C C C C C A A A A A A A A C C C C C C C B 8 A A A 9 9 9 9 9 9 9 9 8 A 8 C C C C 8 8 8 8 C C 9 A 8 8 8 A A 9 B 9 A A B 9 A A A C C A C C C C C C C C C
8 C C C C C C C C C C C C C C C C C 8 C C C C C 8 C C C C 8 C A 9 A 9 A A A C C C 9 C C C 9 9 8 8 A 8 9 9 9 9 9 9 9 A 8 A C C C C C C C C C C 8 8 8 8 9 A B A A A A A A A A A 9 A A 8 A C C C C C C C C
C C C C C C C C C C C C C C C 8 C C C C C C C C C C C C C C A A A A A A A A 8 C C C C C 9 9 9 8 A 8 A 9 9 9 9 9 9 B 9 8 A B C C 8 C 8 8 C C C 8 8 A B A 9 A A 9 A 9 A 9 A A 9 A A A 8 C C C C C C C C C
C C C C C C C C C C C C C C C C C C C C C C C C C C C C C A 8 9 C A A 9 A A C C C C C C 9 B B B A 8 8 B 8 A 8 8 8 A 8 8 9 9 8 8 C C C 8 C C C C C A 8 8 9 A A A 9 B 9 A A A A A C A C C C C C C C C C C
8 C C C 8 C C C C C C C C C C C C C C C 8 C 8 C C C C C C C C 9 A A A 9 A 9 C C C C C 9 A 8 A B A A A B A 9 8 B 9 9 B A A A A A C C 8 C C 8 C C C A A A 9 8 A A A A A A A A A A C C C C C C C C C C 8 C
8 C C C C C C C C C C C 8 C C C C C C C C C C C C C C C C C 9 C A A C A A A C C 8 C C A 8 A A A 8 A A 8 8 B 8 8 9 9 9 8 A A A A 8 C C C C 8 C C C C 9 9 A 9 A A A 9 A 9 A A C C 9 C C C C C C C C C C C
C C C C C C C 8 C C C C C C C C 8 C C C C C C C C C C C C A C C C A 8 A 9 A A A A 9 A A 9 A A A 8 A A 9 8 9 A 8 9 9 9 8 A A A 9 9 C C C C C 8 8 C C C B 9 A A 9 B B A A A B A B A C C C C C C C C C C C
C C C C C C C C C C C C 8 C C C C C C C C C C C C C C C 8 C A C C A C 9 A A 9 A A A A A B 9 9 9 A 9 9 A 8 A 9 9 A A 8 8 A A A B 9 9 8 C C C C C C C C 9 9 A 9 9 9 9 A A A 9 A 9 C A C C C 8 C C C C C C
C C C C C C C C C C C C C C C C C C C C C C C C C C C C C C C C C C A A A A 9 9 A 9 A A A 9 9 9 A A B 8 A 8 8 8 A A A A 9 9 9 9 9 9 8 C C C C C C C C 9 B 9 A 9 9 B A A A A A A C C C C C C C 8 C C C C
C C C C C C C C 8 C C C C C C C C C C C C C C 8 C C C C C C C C 9 C 9 A C 9 A A A 9 A A A 9 9 9 A A B A A A A B A B B 9 9 9 9 B 8 A 8 C C C C C C C B B 9 A A A A A A 9 9 A A C 8 C C 8 C C C C C C C C
C C C C C C 8 C C C C C C C C C 8 C C C C C C C C C C C C C C C C 8 C C A A A A A A A A 9 A A A A 9 A A A A A B A A 9 9 9 9 9 9 9 A A B C C C C C C C B A A A B 9 9 C 9 A C A C C A C C C C C C 8 C C C
C C C C C C C C C C C C C C C C C C 8 C C C C C C C C C C C C C C C C C A 9 A 9 A A 9 A A A A A A A B 8 A A A A B 8 B 9 9 B 9 9 9 9 9 9 8 C C C C C C A A A A A A A A 8 A A 9 8 8 C C C C C C C 8 C C C
C C C C C C C C C C C 8 C C C C C C C C C 8 C C C C C C C C C C C C A C A A A A A A A A A B A A 9 A 9 8 9 A B 8 A A A 9 8 A 9 9 9 9 9 9 9 A A A A A A A 9 A A 9 A A A C A C 9 C C C C C C C C C C C C C
C C C C C C C C C C C C C C C C C C C C C C C C C C C C C C C C C C C C C C A A A 9 A 9 A A A B A B 9 A 8 9 9 9 A 9 A A 9 A A 9 9 B 9 9 9 9 9 A 9 A A A A A A 9 A A C A C C 8 9 C 8 C C C C 8 C C C C C
C C C C C C C C C C C C C C C C C C C C C C C C C C C C C C C C C C C A A C A C C A A A A A A 9 A A 9 B A 9 9 9 A A A A A A A 9 9 9 A A 9 9 9 B A A A A A A A A A A A C C C C C C C C C C C C C C C C C
C C C C C C C C C C C C C C C 8 8 C C C C C C C C C C C C C C C C C A C 8 C C C C A A A A A A A A A A B A 9 9 9 A A 9 A A A A A A A A A 9 9 9 A A A A A A A A C A A D A 9 C C C C C C C C C C C C C C C
C C C C C C C C C C C 8 C C C C C C C C 8 8 C C C C C C C C C C C C C C C A A C A C A C A A A A A 9 9 A A A 9 A A A 9 A A 9 A A 9 A A A A A A A A A A A A A 9 A A C A C C C C C C C C C C C C C C C C C
C C C C C C C C C C C C C C C C C C C C C C C C C C C C C C C C C C C C C A A C A C A A A A A A A A A A 9 9 A A A A 9 B A A 9 A A A A 9 9 A A A A 9 A A 9 A A 9 C C C C C C C C 8 C 8 C C C C C C C C C
C C 8 C C C C C C 8 C C C 8 C C C C C C C C C C C C C 8 C 8 C C C C C C C C C 8 A C C A A C A A A A 9 A A A A A A A A A A A A A A A A A A A A A 9 A A C C A 8 C A C C C C C C C C C C C C C C C C C C C
C C C C C C C C C C C C C C C C C C C C C C C C C C C C C C C C C C C C C C C C A C C C C A C A 9 A 9 A A A A A A A A A 9 A A 9 A A A A A A A A A A 9 A A A A C C C C C C C C C C C 8 C C C C C C C C C
C C C C 8 C C C C C C C C C C C 8 C C C C C C C C C C C C C C C C C C C C C C C C C 8 9 9 8 A A A 9 C A C A A A A A A A A A A A 9 A 9 A A A A A C A A A 8 C A C C C C C C C C C 8 C C C C C C C C C C C
