100 100
5 0 0 0 0 0 0 0 0 0 0 0 0 0 0 0 3 3 0 5 0 0 0 0 0 0 0 0 0 0 0 0 0 8 8 8 8 8 8 8 8 8 8 8 8 8 5 8 3 3 8 8 8 8 8 8 8 8 8 8 8 8 8 8 8 8 D D D D D D D D D D D D D D D D D D D D D D D D D D D D D D D D D D
0 0 0 0 0 0 0 5 0 0 0 0 0 0 0 0 3 3 0 0 0 0 0 0 0 0 5 0 0 0 0 0 0 8 8 8 8 8 8 8 8 8 5 8 8 8 8 8 3 3 8 8 8 8 8 8 8 8 8 8 8 8 8 8 8 5 D D D D D D D D D D D D D D D D D D D D D D D D D D D D D D D D D D
0 0 0 0 0 0 0 0 0 0 0 0 0 0 5 0 3 3 0 0 0 0 0 0 0 0 0 0 0 0 0 0 0 8 8 8 8 8 5 8 8 8 8 8 8 8 8 8 3 3 8 8 8 8 8 8 8 8 8 8 8 5 8 8 8 8 D D D D D D D D D D D D D D D D D D D D D D D D D D D D D D D D D D
0 0 5 0 0 0 0 0 0 0 0 0 0 0 0 0 3 3 0 0 0 5 0 0 0 0 0 0 0 0 0 0 0 8 5 8 8 8 8 8 8 8 8 8 8 8 8 8 3 3 8 8 8 8 8 8 8 5 8 8 8 8 8 8 8 8 D D D D D D D D D D D D D D D D D D D D D D D D D D D D D D D D D D
0 0 0 0 0 0 0 0 0 5 0 0 0 0 0 0 3 3 0 0 0 0 0 0 0 0 0 0 5 0 0 0 0 8 8 8 8 8 8 8 8 8 8 8 8 8 8 8 3 3 8 8 8 5 8 8 8 8 8 8 8 8 8 8 8 8 D D D D D D D D D D D D D D D D D D D D D D D D D D D D D D D D D D
0 0 0 0 0 0 0 0 0 0 0 0 0 0 0 0 3 3 0 0 0 0 0 0 0 0 0 0 0 0 0 0 0 8 8 8 8 8 8 8 8 8 8 8 8 8 8 8 3 3 8 8 8 8 8 8 8 8 8 8 8 8 8 8 8 8 D D D D D D D D D D D D D D D D D D D D D D D D D D D D D D D D D D
0 0 0 0 5 0 0 0 0 0 0 0 0 0 0 0 3 3 0 0 0 0 0 5 0 0 0 0 0 0 0 0 0 8 8 8 8 8 8 8 8 8 8 8 8 5 8 8 3 3 8 8 8 8 8 8 8 8 8 8 8 8 8 8 8 8 D D D D D D D D D D D D D D D D D D D D D D D D D D D D D D D D D D
0 0 0 0 0 0 0 0 0 0 0 5 0 0 0 0 3 3 0 0 0 0 0 0 0 0 0 0 0 0 5 0 0 8 8 8 8 8 8 8 8 5 8 8 8 8 8 8 3 3 8 8 8 8 8 8 8 8 8 8 8 8 8 8 5 8 D D D D D D D D D D D D D D D D D D D D D D D D D D D D D D D D D D
0 0 0 0 0 0 0 0 0 0 0 0 0 0 0 0 3 3 5 0 0 0 0 0 0 0 0 0 0 0 0 0 0 8 8 8 8 5 8 8 8 8 8 8 8 8 8 8 3 3 8 8 8 8 8 8 8 8 8 8 5 8 8 8 8 8 D D D D D D D D D D D D D D D D D D D D D D D D D D D D D D D D D D
0 0 0 0 0 0 5 0 0 0 0 0 0 0 0 0 3 3 0 0 0 0 0 0 0 5 0 0 0 0 0 0 0 5 8 8 8 8 8 8 8 8 8 8 8 8 8 8 3 3 8 8 8 8 8 8 5 8 8 8 8 8 8 8 8 8 D D D D D D D D D D D D D D D D D D D D D D D D D D D D D D D D D D
0 0 0 0 0 0 0 0 0 0 0 0 0 5 0 0 3 3 0 0 0 0 0 0 0 0 0 0 0 0 0 0 5 8 8 8 8 8 8 8 8 8 8 8 8 8 8 8 3 3 8 8 5 8 8 8 8 8 8 8 8 8 8 8 8 8 D D D D D D D D D D D D D D D D D D D D D D D D D D D D D D D D D D
0 5 0 0 0 0 0 0 0 0 0 0 0 0 0 0 3 3 0 0 5 0 0 0 0 0 0 0 0 0 0 0 0 8 8 8 8 8 8 8 8 8 8 8 8 8 8 8 3 3 8 8 8 8 8 8 8 8 8 8 8 8 8 8 8 8 D D D D D D D D D D D D D D D D D D D D D D D D D D D D D D D D D D
0 0 0 0 0 0 0 0 5 0 0 0 0 0 0 0 3 3 0 0 0 0 0 0 0 0 0 5 0 0 0 0 0 8 8 8 8 8 8 8 8 8 8 8 5 8 8 8 3 3 8 8 8 8 8 8 8 8 8 8 8 8 8 8 8 8 D D D D D D D D D D D D D D D D D D D D D D D D D D D D D D D D D D
0 0 0 0 0 0 0 0 0 0 0 0 0 0 0 5 3 3 0 0 0 0 0 0 0 0 0 0 0 0 0 0 0 8 8 8 8 8 8 8 5 8 8 8 8 8 8 8 3 3 8 8 8 8 8 8 8 8 8 8 8 8 8 5 8 8 D D D D D D D D D D D D D D D D D D D D D D D D D D D D D D D D D D
0 0 0 5 0 0 0 0 0 0 0 0 0 0 0 0 3 3 0 0 0 0 5 0 0 0 0 0 0 0 0 0 0 8 8 8 5 8 8 8 8 8 8 8 8 8 8 8 3 3 8 8 8 8 8 8 8 8 8 5 8 8 8 8 8 8 D D D D D D D D D D D D D D D D D D D D D D D D D D D D D D D D D D
0 0 0 0 0 0 0 0 0 0 5 0 0 0 0 0 3 3 0 0 0 0 0 0 0 0 0 0 0 5 0 0 0 8 8 8 8 8 8 8 8 8 8 8 8 8 8 8 3 3 8 8 8 8 8 5 8 8 8 8 8 8 8 8 8 8 D D D D D D D D D D D D D D D D D D D D D D D D D D D D D D D D D D
0 0 0 0 0 0 0 0 0 0 0 0 0 0 0 0 3 3 0 0 0 0 0 0 0 0 0 0 0 0 0 0 0 8 8 8 8 8 8 8 8 8 8 8 8 8 8 8 3 3 8 5 8 8 8 8 8 8 8 8 8 8 8 8 8 8 D D D D D D D D D D D D D D D D D D D D D D D D D D D D D D D D D D
0 0 0 0 0 5 0 0 0 0 0 0 0 0 0 0 3 3 0 0 0 0 0 0 5 0 0 0 0 0 0 0 0 8 8 8 8 8 8 8 8 8 8 8 8 8 8 5 3 3 8 8 8 8 8 8 8 8 8 8 8 8 8 8 8 8 D D D D D D D D D D D D D D D D D D D D D D D D D D D D D D D D D D
0 0 0 0 0 0 0 0 0 0 0 0 5 0 0 0 3 3 0 0 0 0 0 0 0 0 0 0 0 0 0 5 0 8 8 8 8 8 8 8 8 8 8 5 8 8 8 8 3 3 8 8 8 8 8 8 8 8 8 8 8 8 8 8 8 8 D D D D D D D D D D D D D D D D D D D D D D D D D D D D D D D D D D
5 0 0 0 0 0 0 6 6 6 6 6 6 6 6 6 3 3 0 5 0 0 0 0 0 0 0 0 0 0 0 0 0 8 8 8 8 8 8 5 8 8 8 8 8 8 8 8 3 3 8 8 8 8 8 8 8 8 8 8 8 8 5 8 8 8 D D D D D D D D D D D D D D D D D D D D D D D D D D D D D D D D D D
0 0 0 0 0 0 0 6 4 4 4 4 4 4 4 6 3 3 0 0 0 0 0 0 0 0 5 0 0 0 0 0 0 8 8 5 8 8 8 8 8 8 8 8 8 8 8 8 3 3 8 8 8 8 8 8 8 8 5 8 8 8 8 8 8 8 D D D D D D D D D D D D D D D D D D D D D D D D D D D D D D D D D D
0 0 0 0 0 0 0 6 4 4 4 4 4 4 4 6 3 3 0 0 0 0 0 0 0 0 0 0 0 0 0 0 0 8 8 8 8 8 8 8 8 8 8 8 8 8 8 8 3 3 8 8 8 8 5 8 8 8 8 8 8 8 8 8 8 8 D D D D D D D D D D D D D D D D D D D D D D D D D D D D D D D D D D
0 0 5 0 0 0 0 6 4 4 4 4 4 4 4 6 3 3 0 0 0 5 0 0 0 0 0 0 0 0 0 0 0 8 8 8 8 8 8 8 8 8 8 8 8 8 8 8 3 3 5 8 8 8 8 8 8 8 8 8 8 8 8 8 8 8 D D D D D D D D D D D D D D D D D D D D D D D D D D D D D D D D D D
0 0 0 0 0 0 0 6 4 4 4 4 4 4 4 6 3 3 0 0 0 0 0 0 0 0 0 0 5 0 0 0 0 8 8 8 8 8 8 8 8 8 8 8 8 8 5 8 3 3 8 8 8 8 8 8 8 8 8 8 8 8 8 8 8 8 D D D D D D D D D D D D D D D D D D D D D D D D D D D D D D D D D D
0 0 0 0 0 0 0 6 4 4 4 4 4 4 4 6 3 3 0 0 0 0 0 0 0 0 0 0 0 0 0 0 0 8 8 8 8 8 8 8 8 8 5 8 8 8 8 8 3 3 8 8 8 8 8 8 8 8 8 8 8 8 8 8 8 5 D D D D D D D D D D D D D D D D D D D D D D D D D D D D D D D D D D
0 0 0 0 5 0 0 6 4 4 4 4 4 4 4 6 3 3 0 0 0 0 0 5 0 0 0 0 0 0 0 0 0 8 8 8 8 8 5 8 8 8 8 8 8 8 8 8 3 3 8 8 8 8 8 8 8 8 8 8 8 5 8 8 8 8 D D D D D D D D D D D D D D D D D D D D D D D D D D D D D D D D D D
0 0 0 0 0 0 0 6 4 4 4 4 4 4 4 6 3 3 0 0 0 0 0 0 0 0 0 0 0 0 5 0 0 8 5 8 8 8 8 8 8 8 8 8 8 8 8 8 3 3 8 8 8 8 8 8 8 5 8 8 8 8 8 8 8 8 D D D D D D D D D D D D D D D D D D D D D D D D D D D D D D D D D D
0 0 0 0 0 0 0 6 4 4 4 4 4 4 4 6 3 3 5 0 0 0 0 0 0 0 0 0 0 0 0 0 0 8 8 8 8 8 8 8 8 8 8 8 8 8 8 8 3 3 8 8 8 5 8 8 8 8 8 8 8 8 8 8 8 8 D D D D D D D D D D D D D D D D D D D D D D D D D D D D D D D D D D
0 0 0 0 0 0 5 6 4 4 4 4 4 4 4 6 3 3 0 0 0 0 0 0 0 5 0 0 0 0 0 0 0 8 8 8 8 8 8 8 8 8 8 8 8 8 8 8 3 3 8 8 8 8 8 8 8 8 8 8 8 8 8 8 8 8 D D D D D D D D D D D D D D D D D D D D D D D D D D D D D D D D D D
0 0 0 0 0 0 0 6 4 4 4 4 4 4 4 6 3 3 0 0 0 0 0 0 0 0 0 0 0 0 0 0 5 8 8 8 8 8 8 8 8 8 8 8 8 5 8 8 3 3 8 8 8 8 8 8 8 8 8 8 8 8 8 8 8 8 D D D D D D D D D D D D D D D D D D D D D D D D D D D D D D D D D D
0 5 0 0 0 0 0 6 4 4 4 4 4 4 4 6 3 3 0 0 5 0 0 0 0 0 0 0 0 0 0 0 0 8 8 8 8 8 8 8 8 5 8 8 8 8 8 8 3 3 A A 8 8 8 8 8 8 8 8 8 8 8 8 5 8 D D D D D D D D D D D D D D D D D D D D D D D D D D D D D D D D D D
0 0 0 0 0 0 0 6 6 6 6 6 6 6 6 6 3 3 0 0 0 0 0 0 0 0 0 5 0 0 0 0 0 8 8 8 8 5 8 8 8 8 8 8 8 8 8 8 3 3 A A 8 8 8 8 8 8 8 8 5 8 8 8 8 8 D D D D D D D D D D D D D D D D D D D D D D D D D D D D D D D D D D
0 0 0 0 0 0 0 0 0 0 0 0 0 0 0 5 3 3 0 0 0 0 0 0 0 0 0 0 0 0 0 0 0 5 8 8 8 8 8 8 8 8 8 8 8 8 8 8 3 3 3 3 8 8 8 8 5 8 8 8 8 8 8 8 8 8 D D D D D D D D D D D D D D D D D D D D D D D D D D D D D D D D D D
0 0 0 5 0 0 0 0 0 0 0 0 0 0 0 0 3 3 0 0 0 0 5 0 0 0 0 0 0 0 0 0 0 8 8 8 8 8 8 8 8 8 8 8 8 8 8 8 3 3 8 8 5 8 8 8 8 8 8 8 8 8 8 8 8 8 D D D D D D D D D D D D D D D D D D D D D D D D D D D D D D D D D D
0 0 0 0 0 0 0 0 0 0 5 0 0 0 0 0 3 3 0 0 0 0 0 0 0 0 0 0 0 5 0 0 0 8 8 8 8 8 8 8 8 8 8 8 8 8 8 8 3 3 8 8 8 8 8 8 8 8 8 8 8 8 8 8 8 8 D D D D D D D D D D D D D D D D D D D D D D D D D D D D D D D D D D
0 0 0 0 0 0 0 0 0 0 0 0 A A 0 0 3 3 0 0 0 0 0 0 0 0 0 0 0 0 0 0 0 8 8 8 8 8 8 8 8 8 8 8 5 8 8 8 3 3 8 8 8 8 8 8 8 8 8 8 8 8 8 8 8 8 D D D D D D D D D D D D D D D D D D D D D D D D D D D D D D D D D D
0 0 0 0 0 5 0 0 0 0 0 0 A A 0 0 3 3 0 0 0 0 0 0 5 0 0 0 0 0 0 0 0 8 8 8 8 8 8 8 5 8 8 8 8 8 8 8 3 3 8 8 8 8 8 8 8 8 8 8 8 8 8 5 8 8 D D D D D D D D D D D D D D D D D D D D D D D D D D D D D D D D D D
0 0 0 0 0 0 0 0 0 0 0 0 3 0 0 0 3 3 0 0 0 0 0 0 0 0 0 0 0 0 0 5 0 8 8 8 5 8 8 8 8 8 8 8 8 8 8 8 3 3 8 8 8 8 8 8 8 8 8 5 8 8 8 8 8 8 D D D D D D D D D D D D D D D D D D D D D D D D D D D D D D D D D D
5 0 0 0 0 0 0 0 0 0 0 0 3 0 0 0 3 3 0 5 0 0 0 0 0 0 0 0 0 0 0 0 0 8 8 8 8 8 8 8 8 8 8 8 8 8 8 8 3 3 8 8 8 8 8 5 8 8 8 8 8 8 8 8 8 8 D D D D D D D D D D D D D D D D D D D D D D D D D D D D D D D D D D
0 0 0 0 0 0 0 5 0 0 0 0 3 0 0 0 3 3 0 0 0 0 0 0 0 0 5 0 0 0 0 0 0 8 8 8 8 8 8 8 8 8 8 8 8 8 8 8 3 3 8 5 8 8 8 8 8 8 8 8 8 8 8 8 8 8 D D D D D D D D D D D D D D D D D D D D D D D D D D D D D D D D D D
0 0 0 0 0 0 0 0 0 0 0 0 3 0 5 0 3 3 0 0 0 0 0 0 0 0 0 0 0 0 0 0 0 8 8 8 8 8 8 8 8 8 8 8 8 8 8 5 3 3 8 8 8 8 8 8 8 8 8 8 8 8 8 8 8 8 D D D D D D D D D D D D D D D D D D D D D D D D D D D D D D D D D D
0 0 5 0 0 0 0 0 0 0 0 0 3 0 0 0 3 3 0 0 0 5 0 0 0 0 0 0 0 0 0 0 0 8 8 8 8 8 8 8 8 8 8 5 8 8 8 8 3 3 8 8 8 8 8 8 8 8 8 8 8 8 8 8 8 8 D D D D D D D D D D D D D D D D D D D D D D D D D D D D D D D D D D
0 0 0 0 0 0 0 0 0 5 0 0 3 0 0 0 3 3 0 0 0 0 0 0 0 0 0 0 5 0 0 0 0 8 8 8 8 8 8 5 8 8 8 8 8 8 8 8 3 3 8 8 8 8 8 8 8 8 8 8 8 8 5 8 8 8 D D D D D D D D D D D D D D D D D D D D D D D D D D D D D D D D D D
0 0 0 0 0 0 0 0 0 0 0 0 3 0 0 0 3 3 0 0 0 0 0 0 0 0 0 0 0 0 0 0 0 8 8 5 8 8 8 8 8 8 8 8 8 8 8 8 3 3 8 8 8 8 8 8 8 8 5 8 8 8 8 8 8 8 D D D D D D D D D D D D D D D D D D D D D D D D D D D D D D D D D D
0 0 0 0 5 0 0 0 0 0 0 0 3 0 0 0 3 3 0 0 0 0 0 5 0 0 0 0 0 0 0 0 0 8 8 8 8 8 8 8 8 8 8 8 8 8 8 8 3 3 8 8 8 8 5 8 8 8 8 8 8 8 8 8 8 8 D D D D D D D D D D D D D D D D D D D D D D D D D D D D D D D D D D
0 0 0 0 0 0 0 0 0 0 0 5 3 0 0 0 3 3 0 0 0 0 0 0 0 0 0 0 0 0 5 0 0 8 8 8 8 8 8 8 8 8 8 8 8 8 8 8 3 3 5 8 8 8 8 8 8 8 8 8 8 8 8 8 8 8 D D D D D D D D D D D D D D D D D D D D D D D D D D D D D D D D D D
0 0 0 0 0 0 0 0 0 0 0 0 3 0 0 0 3 3 5 0 0 0 0 0 0 0 0 0 0 0 0 0 0 8 8 8 8 8 8 8 8 8 8 8 8 8 5 8 3 3 8 8 8 8 8 8 8 8 8 8 8 8 8 8 8 8 D D D D D D D D D D D D D D D D D D D D D D D D D D D D D D D D D D
0 0 0 0 0 0 5 0 0 0 0 0 3 0 0 0 3 3 0 0 0 0 0 0 0 5 0 0 0 0 0 0 0 8 8 8 8 8 8 8 8 8 5 8 8 8 8 8 3 3 8 8 8 8 8 8 8 8 8 8 8 8 8 8 8 5 D D D D D D D D D D D D D D D D D D D D D D D D D D D D D D D D D D
0 0 0 0 0 0 0 0 0 0 0 0 3 5 0 0 3 3 0 0 0 0 0 0 0 0 0 0 0 0 0 0 5 8 8 8 8 8 5 8 8 8 8 8 8 8 8 8 3 3 8 8 8 8 8 8 8 8 8 8 8 5 8 8 8 8 D D D D D D D D D D D D D D D D D D D D D D D D D D D D D D D D D D
0 5 0 0 0 0 0 0 0 0 0 0 3 0 0 0 3 3 0 0 5 0 0 0 0 0 0 0 0 0 0 0 0 8 5 8 8 8 8 8 8 8 8 8 8 8 8 8 3 3 8 8 8 8 8 8 8 5 8 8 8 8 8 8 8 8 D D D D D D D D D D D D D D D D D D D D D D D D D D D D D D D D D D
3 3 3 3 3 3 3 3 3 3 3 3 3 3 3 3 3 3 3 3 3 3 3 3 3 3 3 3 3 3 3 3 3 3 3 3 3 3 3 3 3 3 3 3 3 3 3 3 3 3 3 3 3 3 3 3 3 3 3 3 3 3 3 3 3 3 3 3 3 3 3 3 3 3 3 3 3 3 3 3 3 3 3 3 3 3 3 3 3 3 3 3 3 3 3 3 3 3 3 3
0 0 0 0 0 0 0 0 0 0 0 0 0 0 0 5 3 3 0 0 0 0 0 0 0 0 0 0 0 0 0 0 0 8 8 8 8 8 8 8 8 8 8 8 8 8 8 8 3 3 8 8 8 8 8 8 8 8 8 8 8 8 8 8 8 8 D D D D D D D D D D D D D D D D D D D D D D D D D D D D D D D D D D
0 0 0 5 0 0 0 0 0 0 0 0 0 0 0 0 3 3 0 0 0 0 5 0 0 0 0 0 0 0 0 0 0 8 8 8 8 8 8 8 8 8 8 8 8 5 8 8 3 3 8 8 8 8 8 8 8 8 8 8 8 8 8 8 8 8 D D D D D D D D D D D D D D D D D D D D D D D D D D D D D D D D D D
0 0 0 0 0 0 0 0 0 0 5 0 0 0 0 0 3 3 0 0 0 0 0 0 0 0 0 0 0 5 0 0 0 8 8 8 8 8 8 8 8 5 8 8 8 8 8 8 3 3 8 8 8 8 8 8 8 8 8 8 8 8 8 8 5 8 D D D D D D D D D D D D D D D D D D D D D D D D D D D D D D D D D D
0 0 0 0 0 0 0 0 0 0 0 0 0 0 0 0 3 3 0 0 0 0 0 0 0 0 0 0 0 0 0 0 0 8 8 8 8 5 8 8 8 8 8 8 8 8 8 8 3 3 8 8 8 8 8 8 8 8 8 8 5 8 8 8 8 8 D D D D D D D D D D D D D D D D D D D D D D D D D D D D D D D D D D
0 0 0 0 0 5 0 0 0 0 0 0 0 0 0 0 3 3 0 0 0 0 0 0 5 0 0 0 0 0 0 0 0 5 8 8 8 8 8 8 8 8 8 8 8 8 8 8 3 3 8 8 8 8 8 8 5 8 8 8 8 8 8 8 8 8 D D D D D D D D D D D D D D D D E E E E E E E E E E E E D D D D D D
0 0 0 0 0 0 0 0 0 0 0 0 5 0 0 0 3 3 0 0 0 0 0 0 0 0 0 0 0 0 0 5 0 8 8 8 8 8 8 8 8 8 8 8 8 8 8 8 3 3 8 8 5 8 8 8 8 8 8 8 8 8 8 8 8 8 D D D D D D D D D D D D D D D D E E F E E E E E E F E E D D D D D D
5 0 0 0 0 0 0 0 0 0 0 0 0 0 0 0 3 3 0 5 0 0 0 0 0 0 0 0 0 0 0 0 0 8 8 8 8 8 8 8 8 8 8 8 8 8 8 8 3 3 8 8 8 8 8 8 8 8 8 8 8 8 8 8 8 8 D D D D D D D D D D D D D D D D E E F E E E E E E F E E D D D D D D
0 0 0 0 0 0 0 5 0 0 0 0 0 0 0 0 3 3 0 0 0 0 0 0 0 0 5 0 0 0 0 0 0 8 8 8 8 8 8 8 8 8 8 8 5 8 8 8 3 3 8 8 8 8 8 8 8 8 8 8 8 8 8 8 8 8 D D D D 3 3 3 3 3 3 3 3 3 3 3 3 F F 3 F E E E E E F E E D D D D D D
0 0 0 0 0 0 0 0 0 0 0 0 0 0 5 0 3 3 0 0 0 0 0 0 0 0 0 0 0 0 0 0 0 8 8 8 8 8 8 8 5 8 8 8 8 8 8 8 3 3 8 8 8 8 8 8 8 8 8 8 8 8 8 5 8 8 D D D D D D D D D D D D D D D D E E F E E E E E E F E E D D D D D D
0 0 5 0 0 0 0 0 0 0 0 0 0 0 0 0 3 3 0 0 0 5 0 0 0 0 0 0 0 0 0 0 0 8 8 8 5 8 8 8 9 9 9 9 9 9 9 9 F 3 8 8 8 8 8 8 8 8 8 5 8 8 8 8 8 8 D D D D D D D D D D D D D D D D E E F E A A A A E F E E D D D D D D
0 0 0 0 0 0 0 0 0 5 0 0 0 0 0 0 3 3 0 0 0 0 0 0 0 0 0 0 5 0 0 0 0 8 8 8 8 8 8 8 9 9 9 9 9 9 9 9 F 3 8 8 8 8 8 5 8 8 8 8 8 8 8 8 8 8 D D D D D D D D D D D D D D D D E E F E A A A A E F E E D D D D D D
0 0 0 0 0 0 0 0 0 0 0 0 0 0 0 0 3 3 0 0 0 0 0 0 0 0 0 0 0 0 0 0 0 8 8 8 8 8 8 8 9 9 9 9 9 9 9 9 F 3 8 5 8 8 8 8 8 8 8 8 8 8 8 8 8 8 D D D D D D D D D D D D D D D D E E F E A A A A E F E E D D D D D D
0 0 0 0 5 0 0 0 0 0 0 0 0 0 0 0 3 3 0 0 0 0 0 5 0 0 0 0 0 0 0 0 0 8 8 8 8 8 8 8 9 9 9 9 9 9 9 9 F 3 8 8 8 8 8 8 8 8 8 8 8 8 8 8 8 8 D D D D D D D D D D D D D D D D E E F E A A A A E F E E D D D D D D
0 0 0 0 0 0 0 0 0 0 0 5 0 0 0 0 3 3 0 0 0 0 0 0 0 0 0 0 0 0 5 0 0 8 8 8 8 8 8 8 9 9 9 9 9 9 9 9 F 3 8 8 8 8 8 8 8 8 8 8 8 8 8 8 8 8 D D D D D D D D D D D D D D D D E E F E F F F F E F E E D D D D D D
0 0 0 0 0 0 0 0 0 0 0 0 0 0 0 0 3 3 5 0 0 0 0 0 0 0 0 0 0 0 0 0 0 8 8 8 8 8 8 5 9 9 9 9 9 9 9 9 F 3 8 8 8 8 8 8 8 8 8 8 8 8 5 8 8 8 D D D D D D D D D D D D D D D D E E F E E E E E E F E E D D D D D D
0 0 0 0 0 0 5 0 0 0 0 0 0 0 0 0 3 3 0 0 0 0 0 0 0 5 0 0 0 0 0 0 0 8 8 5 8 8 8 8 9 9 9 9 9 9 9 9 F 3 8 8 8 8 8 8 8 8 5 8 8 8 8 8 8 8 D D D D D D D D D D D D D D D D E E F E E E E E E F E E D D D D D D
0 0 0 0 0 0 0 0 0 0 0 0 0 5 0 0 3 3 0 0 0 0 0 0 0 0 0 0 0 0 0 0 5 8 8 8 8 8 8 8 9 9 9 9 9 9 9 9 F 3 8 8 8 8 5 8 8 8 8 8 8 8 8 8 8 8 D D D D D D D D D D D D D D D D E E F E E E E E E F E E D D D D D D
0 5 0 0 0 0 0 0 0 0 0 0 0 0 0 0 3 3 0 0 5 0 0 0 0 0 0 0 0 0 0 0 0 8 8 8 8 8 8 8 9 9 9 9 9 9 9 9 F 3 5 8 8 8 8 8 8 8 8 8 8 8 8 8 8 8 D D D D D D D D D D D D D D D D E E E E E E E E E E E E D D D D D D
0 0 0 0 0 0 0 0 5 0 0 0 0 0 0 0 3 3 0 0 0 0 0 0 0 0 0 5 0 0 0 0 0 8 8 8 8 8 8 8 9 9 9 9 9 9 9 9 F 3 8 8 8 8 8 8 8 8 8 8 8 8 8 8 8 8 D D D D D D D D D D D D D D D D D D D D D D D D D D D D D D D D D D
0 0 0 0 0 0 0 0 0 0 0 0 0 0 0 5 3 3 0 0 0 0 0 0 0 0 0 0 0 0 0 0 0 8 8 8 8 8 8 8 9 9 9 9 9 9 9 9 F 3 8 8 8 8 8 8 8 8 8 8 8 8 8 8 8 5 D D D D D D D D E E E D D D D D D D D D D D D D D D D D D D D D D D
0 0 0 5 0 0 0 0 0 0 0 0 0 0 0 0 3 3 0 0 0 0 5 0 0 0 0 0 0 0 0 0 0 8 8 8 8 8 5 8 9 9 9 9 9 9 9 9 F 3 8 8 8 8 8 8 8 8 8 8 8 5 8 8 8 8 D D D D D D D D E E E D D D D D D D D D D D D D D D D D D D D D D D
0 0 0 0 0 0 0 0 0 0 5 0 0 0 0 0 3 3 0 0 0 0 0 0 0 0 0 0 0 5 0 0 0 8 5 8 8 8 8 8 9 9 9 9 9 9 9 9 F 3 8 8 8 8 8 8 8 5 8 8 8 8 8 8 8 8 D D D D D D D D E E E D D D D D D D D D D D D D D D D D D D D D D D
0 0 0 0 0 0 0 0 0 0 0 0 0 0 0 0 3 3 0 0 0 0 0 0 0 0 0 0 0 0 0 0 0 8 8 8 8 8 8 8 9 9 9 9 9 9 9 9 F 3 8 8 8 5 8 8 8 8 8 8 8 8 8 8 8 8 D D D D D D D D E E E D D D D D D D D D D D D D D D D D D D D D D D
0 0 0 0 0 5 0 0 0 0 0 0 0 0 0 0 3 3 0 0 0 0 0 0 5 0 0 0 0 0 0 0 0 8 8 8 8 8 8 8 9 9 9 9 9 9 9 9 F 3 8 8 8 8 8 8 8 8 8 8 8 8 8 8 8 8 D D D D D D D D E E E D D D D D D D D D D D D D D D D D D D D D D D
0 0 0 0 0 0 0 0 0 0 0 0 5 0 0 0 3 3 0 0 0 0 0 0 0 0 0 0 0 0 0 5 0 8 8 8 8 8 8 8 9 9 9 9 9 9 9 9 F 3 8 8 8 8 8 8 8 8 8 8 8 8 8 8 8 8 D D D D D D D D E E E D D D D D D D D D D D D D D D D D D D D D D D
5 0 0 0 0 0 0 0 0 0 0 0 0 0 0 0 3 3 0 5 0 0 0 0 0 0 0 0 0 0 0 0 0 8 8 8 8 8 8 8 8 5 8 8 8 8 8 8 3 3 8 8 8 8 8 8 8 8 8 8 8 8 8 8 5 8 D D D D D D D D E E E D D D D D D D D D D D D D D D D D D D D D D D
0 0 0 0 0 0 0 5 0 0 0 0 0 0 0 0 3 3 0 0 0 0 0 0 0 0 5 0 0 0 0 0 0 8 8 8 8 5 8 8 8 8 8 8 8 8 8 8 3 3 8 8 8 8 8 8 8 8 8 8 5 8 8 8 8 8 D D D D D D D D E E E D D D D D D D D D D D D D D D D D D D D D D D
0 0 0 0 0 0 0 0 0 0 0 0 0 0 5 0 3 3 0 0 0 0 0 0 0 0 0 0 0 0 0 0 0 5 8 8 8 8 8 8 8 8 8 8 8 8 8 8 3 3 8 8 8 8 8 8 5 8 8 8 8 8 8 8 8 8 D D D D D D D D E E E D D D D D D D D D D D D D D D D D D D D D D D
0 0 5 0 0 0 0 0 0 0 0 0 0 0 0 0 3 3 0 0 0 5 0 0 0 0 0 0 0 0 0 0 0 8 8 8 8 8 8 8 8 8 8 8 8 8 8 8 3 3 8 8 5 8 8 8 8 8 8 8 8 8 8 8 8 8 D D D D D D D D E E E D D D D D D D D D D D D D D D D D D D D D D D
0 0 0 0 0 0 0 0 0 5 0 0 0 0 0 0 3 3 0 0 0 0 0 0 0 0 0 0 5 0 0 0 0 8 8 8 8 8 8 8 8 8 8 8 8 8 8 8 3 3 8 8 8 8 8 8 8 8 8 8 8 8 8 8 8 8 D D D D D D D D E E E D D D D D D D D D D D D D D D D D D D D D D D
0 0 0 0 0 0 0 0 0 0 0 0 0 0 0 0 3 3 0 0 0 0 0 0 0 0 0 0 0 0 0 0 0 8 8 8 8 8 8 8 8 8 8 8 5 8 8 8 3 3 8 8 8 8 8 8 8 8 8 8 8 8 8 8 8 8 D D D D D D D D E E E D D D D D D D D D D D D D D D D D D D D D D D
0 0 0 0 5 0 0 0 0 0 0 0 0 0 0 0 3 3 0 0 0 0 0 5 0 0 0 0 0 0 0 0 0 8 8 8 8 8 8 8 5 8 8 8 8 8 8 8 3 3 8 8 8 8 8 8 8 8 8 8 8 8 8 5 8 8 D D D D D D D D E E E D D D D D D D D D D D D D D D D D D D D D D D
0 0 0 0 0 0 0 0 0 0 0 5 0 0 0 0 3 3 0 0 0 0 0 0 0 0 0 0 0 0 5 0 0 8 8 8 5 8 8 8 8 8 8 8 8 8 8 8 3 3 8 8 8 8 8 8 8 8 8 5 8 8 8 8 8 8 D D D D D D D D E E E D D D D D D D D D D D D D D D D D D D D D D D
0 0 0 0 0 0 0 0 0 0 0 0 0 0 0 0 3 3 5 0 0 0 0 0 0 0 0 0 0 0 0 0 0 8 8 8 8 8 8 8 8 8 8 8 8 8 8 8 3 3 8 8 8 8 8 5 8 8 8 8 8 8 8 8 8 8 D D D D D D D D E E E D D D D D D D D D D D D D D D D D D D D D D D
0 0 0 0 0 0 5 0 0 0 0 0 0 0 0 0 3 3 0 0 0 0 0 0 0 5 0 0 0 0 0 0 0 8 8 8 8 8 8 8 8 8 8 8 8 8 8 8 3 3 8 5 8 8 8 8 8 8 8 8 8 8 8 8 8 8 D D D D D D D D E E E D D D D D D D D D D D D D D D D D D D D D D D
0 0 0 0 0 0 0 0 0 0 0 0 0 5 0 0 3 3 0 0 0 0 0 0 0 0 0 0 0 0 0 0 5 8 8 8 8 8 8 8 8 8 8 8 8 8 8 5 3 3 8 8 8 8 8 8 8 8 8 8 8 8 8 8 8 8 D D D D D D D D E E E D D D D D D D D D D D D D D D D D D D D D D D
0 5 0 0 0 0 0 0 0 0 0 0 0 0 0 0 3 3 0 0 5 0 0 0 0 0 0 0 0 0 0 0 0 8 8 8 8 8 8 8 8 8 8 5 8 8 8 8 3 3 8 8 8 8 8 8 8 8 8 8 8 8 8 8 8 8 D D D D D D D D E E E D D D D D D D D D D D D D D D D D D D D D D D
0 0 0 0 0 0 0 0 5 0 0 0 0 0 0 0 3 3 0 0 0 0 0 0 0 0 0 5 0 0 0 0 0 8 8 8 8 8 8 5 8 8 8 8 8 8 8 8 3 3 8 8 8 8 8 8 8 8 8 8 8 8 5 8 8 8 D D D D D D D D E E E D D D D D D D D D D D D D D D D D D D D D D D
0 0 0 0 0 0 0 0 0 0 0 0 0 0 0 5 3 3 0 0 0 0 0 0 0 0 0 0 0 0 0 0 0 8 8 5 8 8 8 8 8 8 8 8 8 8 8 8 3 3 8 8 8 8 8 8 8 8 5 8 8 8 8 8 8 8 D D D D D D D D E E E D D D D D D D D D D D D D D D D D D D D D D D
0 0 0 5 0 0 0 0 0 0 0 0 0 0 0 0 3 3 0 0 0 0 5 0 0 0 0 0 0 0 0 0 0 8 8 8 8 8 8 8 8 8 8 8 8 8 8 8 3 3 8 8 8 8 5 8 8 8 8 8 8 8 8 8 8 8 D D D D D D D D E E E D D D D D D D D D D D D D D D D D D D D D D D
0 0 0 0 0 0 0 0 0 0 5 0 0 0 0 0 3 3 0 0 0 0 0 0 0 0 0 0 0 5 0 0 0 8 8 8 8 8 8 8 8 8 8 8 8 8 8 8 3 3 5 8 8 8 8 8 8 8 8 8 8 8 8 8 8 8 D D D D D D D D E E E D D D D D D D D D D D D D D D D D D D D D D D
0 0 0 0 0 0 0 0 0 0 0 0 0 0 0 0 3 3 0 0 0 0 0 0 0 0 0 0 0 0 0 0 0 8 8 8 8 8 8 8 8 8 8 8 8 8 5 8 3 3 8 8 8 8 8 8 8 8 8 8 8 8 8 8 8 8 D D D D D D D D E E E D D D D D D D D D D D D D D D D D D D D D D D
0 0 0 0 0 5 0 0 0 0 0 0 0 0 0 0 3 3 0 0 0 0 0 0 5 0 0 0 0 0 0 0 0 8 8 8 8 8 8 8 8 8 5 8 8 8 8 8 3 3 8 8 8 8 8 8 8 8 8 8 8 8 8 8 8 5 D D D D D D D D E E E D D D D D D D D D D D D D D D D D D D D D D D
0 0 0 0 0 0 0 0 0 0 0 0 5 0 0 0 3 3 0 0 0 0 0 0 0 0 0 0 0 0 0 5 0 8 8 8 8 8 5 8 8 8 8 8 8 8 8 8 3 3 8 8 8 8 8 8 8 8 8 8 8 5 8 8 8 8 D D D D D D D D E E E D D D D D D D D D D D D D D D D D D D D D D D
5 0 0 0 0 0 0 0 0 0 0 0 0 0 0 0 3 3 0 5 0 0 0 0 0 0 0 0 0 0 0 0 0 8 5 8 8 8 8 8 8 8 8 8 8 8 8 8 3 3 8 8 8 8 8 8 8 5 8 8 8 8 8 8 8 8 D D D D D D D D E E E D D D D D D D D D D D D D D D D D D D D D D D
0 0 0 0 0 0 0 5 0 0 0 0 0 0 0 0 3 3 0 0 0 0 0 0 0 0 5 0 0 0 0 0 0 8 8 8 8 8 8 8 8 8 8 8 8 8 8 8 3 3 8 8 8 5 8 8 8 8 8 8 8 8 8 8 8 8 D D D D D D D D D D D D D D D D D D D D D D D D D D D D D D D D D D
0 0 0 0 0 0 0 0 0 0 0 0 0 0 5 0 3 3 0 0 0 0 0 0 0 0 0 0 0 0 0 0 0 8 8 8 8 8 8 8 8 8 8 8 8 8 8 8 3 3 8 8 8 8 8 8 8 8 8 8 8 8 8 8 8 8 D D D D D D D D D D D D D D D D D D D D D D D D D D D D D D D D D D
0 0 5 0 0 0 0 0 0 0 0 0 0 0 0 0 3 3 0 0 0 5 0 0 0 0 0 0 0 0 0 0 0 8 8 8 8 8 8 8 8 8 8 8 8 5 8 8 3 3 8 8 8 8 8 8 8 8 8 8 8 8 8 8 8 8 D D D D D D D D D D D D D D D D D D D D D D D D D D D D D D D D D D
0 0 0 0 0 0 0 0 0 5 0 0 0 0 0 0 3 3 0 0 0 0 0 0 0 0 0 0 5 0 0 0 0 8 8 8 8 8 8 8 8 5 8 8 8 8 8 8 3 3 8 8 8 8 8 8 8 8 8 8 8 8 8 8 5 8 D D D D D D D D D D D D D D D D D D D D D D D D D D D D D D D D D D

; Recursos
R 30 25 1 1
R 32 24 2 1
R 29 23 3 1
R 31 28 1 1
R 27 29 2 1
