100 100
9 8 8 8 8 8 8 8 8 9 8 8 8 8 8 8 8 8 9 8 8 8 8 8 8 8 8 9 6 5 6 5 3 4 2 2 B 2 2 2 2 2 B 2 4 2 2 2 B 3 2 2 2 2 B 4 2 2 2 2 B 2 2 2 2 2 2 1 4 2 D D 1 D D D 1 D D D 1 D D D 1 D D D 1 D D D 1 D D D 1 D D D
8 7 7 6 7 7 7 7 9 7 7 7 7 6 8 7 7 9 6 7 7 7 7 6 7 7 9 7 4 6 4 6 3 3 3 3 3 3 3 3 3 3 3 3 3 3 3 3 3 3 3 3 3 3 3 3 3 3 3 3 3 3 3 3 3 3 1 4 2 1 0 1 0 1 0 1 0 1 0 1 0 1 0 1 D 1 0 1 0 1 0 1 0 1 0 1 0 1 0 1
8 6 7 7 7 7 6 9 7 7 7 6 7 7 8 7 9 7 7 7 7 8 7 7 7 9 6 7 6 4 6 4 3 2 2 2 2 2 2 2 2 2 4 2 2 2 2 2 2 3 2 2 2 4 2 2 2 2 2 2 2 2 2 2 4 2 4 2 1 1 1 0 1 0 1 0 1 0 1 0 1 0 1 0 D 0 1 0 1 0 1 0 1 0 1 0 1 0 1 0
8 7 7 7 6 7 9 7 7 6 7 7 7 7 8 9 7 7 7 6 7 7 7 7 9 7 7 7 5 6 5 6 3 2 2 2 2 2 2 2 2 4 2 2 2 2 2 2 2 3 2 2 4 2 2 2 2 2 2 2 2 2 2 4 2 2 2 1 1 4 D 1 0 1 0 C 0 1 0 1 C 1 0 1 D 1 0 1 0 1 C D 0 1 0 C 0 1 D 1
8 7 6 7 7 9 7 8 7 7 7 7 6 7 9 7 7 6 7 7 7 8 6 9 7 7 7 6 6 4 6 4 3 2 2 2 B 2 2 2 4 2 B 2 2 2 2 2 B 3 2 4 2 2 B 2 2 2 2 2 B 2 4 2 2 2 1 1 4 1 1 0 1 0 1 0 1 0 1 0 1 0 1 0 1 0 1 0 1 0 1 0 1 0 1 0 1 0 1 0
8 7 7 7 9 6 7 7 7 7 6 7 7 9 8 6 7 7 7 7 6 7 9 7 7 6 7 7 4 6 4 6 3 2 2 2 2 2 2 4 2 2 2 2 2 2 2 2 2 3 4 2 2 2 2 2 2 2 2 2 2 4 2 2 2 2 1 4 1 1 0 1 0 1 0 1 0 1 0 1 0 1 0 1 D 1 0 1 0 1 0 1 0 1 0 1 0 1 0 1
8 7 7 9 7 7 7 8 6 7 7 7 9 6 8 7 7 7 6 7 7 9 7 6 7 7 7 7 6 5 6 5 3 2 2 2 2 2 4 2 2 2 2 2 2 2 2 2 2 3 2 2 2 2 2 2 2 2 2 2 4 2 2 2 2 2 4 1 1 2 1 0 1 0 1 C 1 D 1 0 C 0 1 0 D C 1 0 1 0 1 D 1 0 1 C 1 0 1 0
8 6 9 7 8 7 8 7 8 7 8 9 8 7 8 7 8 7 8 7 9 6 8 7 8 7 8 7 4 6 4 6 3 2 2 2 2 4 2 2 2 2 2 2 2 2 2 2 4 3 2 2 2 2 2 2 2 2 2 4 2 2 2 2 2 2 1 1 2 4 0 1 D 1 0 D 0 1 D 1 0 1 0 1 D 1 0 D 0 1 D 1 0 1 0 1 D 1 0 D
8 9 7 7 6 7 7 8 7 6 9 7 7 7 8 7 7 7 7 9 7 8 7 7 6 7 7 7 6 4 6 4 3 2 2 2 4 2 2 2 2 2 B 2 2 2 2 4 B 3 2 2 2 2 B 2 2 2 4 2 B 2 2 2 2 2 1 2 4 1 1 0 1 0 1 0 1 0 1 0 1 0 1 0 1 0 1 0 1 0 1 0 1 0 1 0 1 0 1 0
9 7 6 7 7 7 7 6 7 9 7 7 6 7 8 7 7 6 9 7 7 7 6 7 7 7 7 9 5 6 5 6 3 2 2 4 2 2 2 2 2 2 2 2 2 2 4 2 2 3 2 2 2 2 2 2 2 4 2 2 2 2 2 2 2 2 2 4 1 2 D 1 0 1 0 1 0 D 0 1 C 1 0 1 D C 0 1 0 1 C 1 0 1 0 1 0 1 D 1
8 7 7 7 7 6 7 8 9 7 6 7 7 7 8 6 7 9 7 7 6 8 7 7 7 6 9 7 6 4 6 4 3 2 4 2 2 2 2 2 2 2 2 2 2 4 2 2 2 3 2 2 2 2 2 2 4 2 2 2 2 2 2 2 2 2 4 1 2 1 1 0 1 0 1 0 1 0 1 0 1 0 1 0 D 0 1 0 1 0 1 0 1 0 1 0 1 0 1 0
8 7 7 6 7 7 7 9 6 7 7 7 7 6 8 7 9 7 6 7 7 7 7 6 7 9 7 7 4 6 4 6 3 4 2 2 2 2 2 2 2 2 2 2 4 2 2 2 2 3 2 2 2 2 2 4 2 2 2 2 2 2 2 2 2 2 1 2 1 4 0 1 0 1 0 1 0 1 0 1 0 1 0 1 D 1 0 1 0 1 0 1 0 1 0 1 0 1 0 1
8 6 7 7 7 7 9 8 7 7 7 6 7 7 8 9 6 7 7 7 7 8 7 7 9 7 6 7 6 5 6 5 3 2 2 2 B 2 2 2 2 2 B 4 2 2 2 2 B 3 2 2 2 2 4 2 2 2 2 2 B 2 2 2 2 4 2 1 4 2 D 0 1 0 1 C 1 D 1 0 1 0 1 0 1 C 1 0 1 0 C D 1 0 1 C 1 0 D 0
8 7 7 7 6 9 7 7 7 6 7 7 7 7 9 7 7 7 7 6 7 7 7 9 6 7 7 7 4 6 4 6 3 2 2 2 2 2 2 2 2 2 4 2 2 2 2 2 2 3 2 2 2 4 2 2 2 2 2 2 2 2 2 2 4 2 1 4 2 1 0 1 0 1 0 1 0 1 0 1 0 1 0 1 D 1 0 1 0 1 0 1 0 1 0 1 0 1 0 1
8 8 8 8 9 8 8 8 8 8 8 8 8 9 8 8 8 8 8 8 8 8 9 8 8 8 8 8 6 4 6 4 3 2 2 2 2 2 2 2 2 4 2 2 2 2 2 2 2 3 2 2 4 2 2 2 2 2 2 2 2 2 2 4 2 2 4 2 1 1 1 0 D 0 1 D 1 0 1 0 1 D 1 0 D 0 1 D 1 0 1 0 1 D 1 0 D 0 1 D
8 7 7 9 7 6 7 7 7 7 6 7 9 7 8 6 7 7 7 7 6 9 7 7 7 6 7 7 5 6 5 6 3 2 2 2 2 2 2 2 4 2 2 2 2 2 2 2 2 3 2 4 2 2 2 2 2 2 2 2 2 2 4 2 2 2 2 1 1 4 D 1 0 1 0 C 0 1 0 1 C 1 0 1 D 1 0 1 0 1 C D 0 1 0 C 0 1 D 1
8 7 9 6 7 7 7 8 6 7 7 9 7 6 8 7 7 7 6 7 9 8 7 6 7 7 7 7 6 4 6 4 3 2 2 2 B 2 2 4 2 2 B 2 2 2 2 2 B 3 4 2 2 2 B 2 2 2 2 2 B 4 2 2 2 2 1 1 4 1 1 0 1 0 1 0 1 0 1 0 1 0 1 0 1 0 1 0 1 0 1 0 1 0 1 0 1 0 1 0
8 9 7 7 7 7 6 7 7 7 9 6 7 7 8 7 6 7 7 9 7 6 7 7 7 7 6 7 4 6 4 6 3 2 2 2 2 2 4 2 2 2 2 2 2 2 2 2 2 3 2 2 2 2 2 2 2 2 2 2 4 2 2 2 2 2 1 4 1 1 0 1 0 1 0 1 0 1 0 1 0 1 0 1 D 1 0 1 0 1 0 1 0 1 0 1 0 1 0 1
9 7 7 7 6 7 7 8 7 9 7 7 7 7 8 7 7 7 9 6 7 8 7 7 6 7 7 9 6 5 6 5 3 3 3 3 3 3 3 3 3 3 3 3 3 3 3 3 3 3 3 3 3 3 3 3 3 3 3 3 3 3 3 3 3 3 4 1 1 2 1 0 1 0 1 C 1 D 1 0 C 0 1 0 D C 1 0 1 0 1 D 1 0 1 C 1 0 1 0
8 7 6 7 7 7 7 6 9 7 7 7 6 7 8 7 7 9 7 7 7 7 6 7 7 7 9 6 4 6 4 6 3 2 2 2 4 2 2 2 2 2 2 2 2 2 2 4 2 3 2 2 2 2 2 2 2 2 4 2 2 2 2 2 2 2 1 1 2 4 0 1 0 1 0 1 0 1 0 1 0 1 0 1 D 1 0 1 0 1 0 1 0 1 0 1 0 1 0 1
8 7 7 7 7 6 7 9 7 7 6 7 7 7 8 6 9 7 7 7 6 8 7 7 7 9 7 7 6 4 6 4 3 2 2 4 B 2 2 2 2 2 B 2 2 2 4 2 B 3 2 2 2 2 B 2 2 4 2 2 B 2 2 2 2 2 1 2 4 1 1 0 1 0 1 0 1 0 1 0 1 0 1 0 1 0 1 0 1 0 1 0 1 0 1 0 1 0 1 0
8 7 8 6 8 7 9 7 8 7 8 7 8 6 8 9 8 7 8 7 8 7 8 6 9 7 8 7 5 6 5 6 3 2 4 2 2 2 2 2 2 2 2 2 2 4 2 2 2 3 2 2 2 2 2 2 4 2 2 2 2 2 2 2 2 2 2 4 1 2 D 1 D D D 1 D D D 1 D D D 1 D D D 1 D D D 1 D D D 1 D D D 1
8 6 7 7 7 9 6 8 7 7 7 6 7 7 9 7 6 7 7 7 7 8 7 9 7 7 6 7 6 4 6 4 3 4 2 2 2 2 2 2 2 2 2 2 4 2 2 2 2 3 2 2 2 2 2 4 2 2 2 2 2 2 2 2 2 2 4 1 2 1 1 0 1 0 1 0 1 0 1 0 1 0 1 0 D 0 1 0 1 0 1 0 1 0 1 0 1 0 1 0
8 7 7 7 9 7 7 7 7 6 7 7 7 9 8 7 7 7 7 6 7 7 9 7 6 7 7 7 4 6 4 6 3 2 2 2 2 2 2 2 2 2 2 4 2 2 2 2 2 3 2 2 2 2 4 2 2 2 2 2 2 2 2 2 2 4 1 2 1 4 0 1 0 1 0 1 0 1 0 1 0 1 0 1 D 1 0 1 0 1 0 1 0 1 0 1 0 1 0 1
8 7 6 9 7 7 7 8 7 7 7 7 9 7 8 7 7 6 7 7 7 9 6 7 7 7 7 6 6 5 6 5 3 2 2 2 B 2 2 2 2 2 4 2 2 2 2 2 B 3 2 2 2 4 B 2 2 2 2 2 B 2 2 2 4 2 2 1 4 2 D 0 1 0 1 C 1 D 1 0 1 0 1 0 1 C 1 0 1 0 C D 1 0 1 C 1 0 D 0
8 7 9 7 7 6 7 7 7 7 6 9 7 7 8 6 7 7 7 7 9 7 7 7 7 6 7 7 4 6 4 6 3 2 2 2 2 2 2 2 2 4 2 2 2 2 2 2 2 3 2 2 4 2 2 2 2 2 2 2 2 2 2 4 2 2 1 4 2 1 0 1 0 1 0 1 0 1 0 1 0 1 0 1 D 1 0 1 0 1 0 1 0 1 0 1 0 1 0 1
8 9 7 6 7 7 7 8 6 7 9 7 7 6 8 7 7 7 6 9 7 8 7 6 7 7 7 7 6 4 6 4 3 2 2 2 2 2 2 2 4 2 2 2 2 2 2 2 2 3 2 4 2 2 2 2 2 2 2 2 2 2 4 2 2 2 4 2 1 1 1 0 1 0 1 0 1 0 1 0 1 0 1 0 D 0 1 0 1 0 1 0 1 0 1 0 1 0 1 0
9 6 7 7 7 7 6 7 7 9 7 6 7 7 8 7 6 7 9 7 7 6 7 7 7 7 6 9 5 6 5 6 3 2 2 2 2 2 2 4 2 2 2 2 2 2 2 2 2 3 4 2 2 2 2 2 2 2 2 2 2 4 2 2 2 2 2 1 1 4 D 1 0 1 0 C 0 1 0 1 C 1 0 1 D 1 0 1 0 1 C D 0 1 0 C 0 1 D 1
8 8 8 8 8 8 8 8 9 8 8 8 8 8 8 8 8 9 8 8 8 8 8 8 8 8 9 8 6 4 6 4 3 2 2 2 B 2 4 2 2 2 B 2 2 2 2 2 B 3 2 2 2 2 B 2 2 2 2 2 4 2 2 2 2 2 1 1 4 1 1 0 1 0 1 D 1 0 D 0 1 D 1 0 1 0 1 D 1 0 D 0 1 D 1 0 1 0 1 D
8 7 6 7 7 7 7 9 7 7 7 7 6 7 8 7 9 6 7 7 7 7 6 7 7 9 7 6 4 6 4 6 3 2 2 2 2 4 2 2 2 2 2 2 2 2 2 2 4 3 2 2 2 2 2 2 2 2 2 4 2 2 2 2 2 2 1 4 1 1 0 1 0 1 0 1 0 1 0 1 0 1 0 1 D 1 0 1 0 1 0 E E E E E E E 0 1
8 7 7 7 7 6 9 8 7 7 6 7 7 7 8 9 7 7 7 7 6 8 7 7 9 6 7 7 6 5 6 5 3 2 2 2 4 2 2 2 2 2 2 2 2 2 2 4 2 3 2 2 2 2 2 2 2 2 4 2 2 2 2 2 2 2 4 1 1 2 1 0 1 0 1 C 1 D 1 0 C 0 1 0 D C 1 0 1 E E E E E E E E E E E
8 7 7 6 7 9 7 7 6 7 7 7 7 6 9 7 7 7 6 7 7 7 7 9 7 7 7 7 4 6 4 6 3 2 2 4 2 2 2 2 2 2 2 2 2 2 4 2 2 3 2 2 2 2 2 2 2 4 2 2 2 2 2 2 2 2 1 1 2 4 0 1 0 1 0 1 0 1 0 1 0 1 0 1 D 1 0 1 E E E E E E E E E E E E
8 6 7 7 9 7 6 8 7 7 7 6 7 9 8 7 6 7 7 7 7 8 9 7 7 7 6 7 6 4 6 4 3 2 4 2 B 2 2 2 2 2 B 2 2 4 2 2 B 3 2 2 2 2 B 2 4 2 2 2 B 2 2 2 2 2 1 2 4 1 1 0 1 0 1 0 1 0 1 0 1 0 1 0 1 0 1 E E E E E E E E E E E E E
8 7 7 9 6 7 7 7 7 6 7 7 9 7 8 7 7 7 7 6 7 9 7 7 6 7 7 7 5 6 5 6 3 4 2 2 2 2 2 2 2 2 2 2 4 2 2 2 2 3 2 2 2 2 2 4 2 2 2 2 2 2 2 2 2 2 2 4 1 2 D 1 0 1 0 1 0 D 0 1 C 1 0 1 D C E E E E E E E E E E E E E E
8 7 9 7 7 7 7 8 7 7 7 9 6 7 8 7 7 6 7 7 9 8 6 7 7 7 7 6 6 4 6 4 3 2 2 2 2 2 2 2 2 2 2 4 2 2 2 2 2 3 2 2 2 2 4 2 2 2 2 2 2 2 2 2 2 4 4 1 2 1 1 0 1 0 1 0 1 0 1 0 1 0 1 0 D 0 E E E E E E E E E E E E E E
8 9 8 7 8 6 8 7 8 7 9 7 8 7 8 6 8 7 8 9 8 7 8 7 8 6 8 7 4 6 4 6 3 3 3 3 3 3 3 3 3 3 3 3 3 3 3 3 3 3 3 3 3 3 3 3 3 3 3 3 3 3 3 3 3 3 1 2 1 4 0 1 D 1 0 D 0 1 D 1 0 1 0 1 D E E E E E E E E E E E E E E E
9 7 7 6 7 7 7 8 6 9 7 7 7 6 8 7 7 7 9 7 7 8 7 6 7 7 7 9 6 5 6 5 3 2 2 2 B 2 2 2 2 4 B 2 2 2 2 2 B 3 2 2 4 2 B 2 2 2 2 2 B 2 2 4 2 2 2 1 4 2 D 0 1 0 1 C 1 D 1 0 1 0 1 0 1 E E E E E E E E E E E E E E E
8 6 7 7 7 7 6 7 9 7 7 6 7 7 8 7 6 9 7 7 7 6 7 7 7 7 9 7 4 6 4 6 3 2 2 2 2 2 2 2 4 2 2 2 2 2 2 2 2 3 2 4 2 2 2 2 2 2 2 2 2 2 4 2 2 2 1 4 2 1 0 1 0 1 0 1 0 1 0 1 0 1 0 1 D E E E E E E E E E E E E E E E
8 7 7 7 6 7 7 9 7 6 7 7 7 7 8 7 9 7 7 6 7 8 7 7 6 9 7 7 6 4 6 4 3 2 2 2 2 2 2 4 2 2 2 2 2 2 2 2 2 3 4 2 2 2 2 2 2 2 2 2 2 4 2 2 2 2 4 2 1 1 1 0 1 0 1 0 1 0 1 0 1 0 1 0 D E E E E E E E E E E E E E E E
8 7 6 7 7 7 9 6 7 7 7 7 6 7 8 9 7 6 7 7 7 7 6 7 9 7 7 6 5 6 5 6 3 2 2 2 2 2 4 2 2 2 2 2 2 2 2 2 2 3 2 2 2 2 2 2 2 2 2 2 4 2 2 2 2 2 2 1 1 4 D 1 0 1 0 C 0 1 0 1 C 1 0 1 D E E E E E E E E E E E E E E E
8 7 7 7 7 9 7 8 7 7 6 7 7 7 9 6 7 7 7 7 6 8 7 9 7 6 7 7 6 4 6 4 3 2 2 2 B 4 2 2 2 2 B 2 2 2 2 2 4 3 2 2 2 2 B 2 2 2 2 4 B 2 2 2 2 2 1 1 4 1 1 0 1 0 1 0 1 0 1 0 1 0 1 0 1 E E E E E E E E E E E E E E E
8 7 7 6 9 7 7 7 6 7 7 7 7 9 8 7 7 7 6 7 7 7 9 6 7 7 7 7 4 6 4 6 3 2 2 2 4 2 2 2 2 2 2 2 2 2 2 4 2 3 2 2 2 2 2 2 2 2 4 2 2 2 2 2 2 2 1 4 1 1 0 1 0 1 0 1 0 1 0 1 0 1 0 1 D E E E E E E E E E E E E E E E
8 8 8 9 8 8 8 8 8 8 8 8 9 8 8 8 8 8 8 8 8 9 8 8 8 8 8 8 6 5 6 5 3 2 2 4 2 2 2 2 2 2 2 2 2 2 4 2 2 3 2 2 2 2 2 2 2 4 2 2 2 2 2 2 2 2 4 1 1 2 1 D D D 1 D D D 1 D D D 1 D D D E E E E E E E E E E E E E E
8 7 9 7 6 7 7 7 7 6 7 9 7 7 8 7 7 7 7 6 9 7 7 7 6 7 7 7 4 6 4 6 3 2 4 2 2 2 2 2 2 2 2 2 2 4 2 2 2 3 2 2 2 2 2 2 4 2 2 2 2 2 2 2 2 2 1 1 2 4 0 1 0 1 0 1 0 1 0 1 0 1 0 1 D 1 E E E E E E E E E E E E E E
8 9 6 7 7 7 7 8 7 7 9 7 6 7 8 7 7 6 7 9 7 8 6 7 7 7 7 6 6 4 6 4 3 4 2 2 B 2 2 2 2 2 B 2 4 2 2 2 B 3 2 2 2 2 B 4 2 2 2 2 B 2 2 2 2 2 1 2 4 1 1 0 1 0 1 0 1 0 1 0 1 0 1 0 1 0 1 E E E E E E E E E E E E E
9 7 7 7 7 6 7 7 7 9 6 7 7 7 8 6 7 7 9 7 6 7 7 7 7 6 7 9 5 6 5 6 3 2 2 2 2 2 2 2 2 2 2 4 2 2 2 2 2 3 2 2 2 2 4 2 2 2 2 2 2 2 2 2 2 4 2 4 1 2 D 1 0 1 0 1 0 D 0 1 C 1 0 1 D C 0 1 E E E E E E E E E E E E
8 7 7 6 7 7 7 8 9 7 7 7 7 6 8 7 7 9 6 7 7 8 7 6 7 7 9 7 6 4 6 4 3 2 2 2 2 2 2 2 2 2 4 2 2 2 2 2 2 3 2 2 2 4 2 2 2 2 2 2 2 2 2 2 4 2 4 1 2 1 1 0 1 0 1 0 1 0 1 0 1 0 1 0 D 0 1 0 1 E E E E E E E E E E E
8 6 7 7 7 7 6 9 7 7 7 6 7 7 8 7 9 7 7 7 7 6 7 7 7 9 6 7 4 6 4 6 3 2 2 2 2 2 2 2 2 4 2 2 2 2 2 2 2 3 2 2 4 2 2 2 2 2 2 2 2 2 2 4 2 2 1 2 1 4 0 1 0 1 0 1 0 1 0 1 0 1 0 1 D 1 0 1 0 1 0 E E E E E E E 0 1
8 7 7 7 6 7 9 8 7 6 7 7 7 7 8 9 7 7 7 6 7 8 7 7 9 7 7 7 6 5 6 5 3 2 2 2 B 2 2 2 4 2 B 2 2 2 2 2 B 3 2 4 2 2 B 2 2 2 2 2 B 2 4 2 2 2 2 1 4 2 D 0 1 0 1 C 1 D 1 0 1 0 1 0 1 C 1 0 1 0 C D 1 0 1 C 1 0 D 0
8 7 8 7 8 9 8 6 8 7 8 7 8 7 9 7 8 6 8 7 8 7 8 9 8 7 8 6 4 6 4 6 3 2 2 2 2 2 2 4 2 2 2 2 2 2 2 2 2 3 4 2 2 2 2 2 2 2 2 2 2 4 2 2 2 2 1 4 2 1 0 1 D 1 0 1 0 1 D 1 0 D 0 1 D 1 0 1 0 1 D 1 0 D 0 1 D 1 0 1
8 7 7 7 9 6 7 8 7 7 6 7 7 9 8 6 7 7 7 7 6 8 9 7 7 6 7 7 6 4 6 4 3 2 2 2 2 2 4 2 2 2 2 2 2 2 2 2 2 3 2 2 2 2 2 2 2 2 2 2 4 2 2 2 2 2 4 2 1 1 1 0 1 0 1 0 1 0 1 0 1 0 1 0 D 0 1 0 1 0 1 0 1 0 1 0 1 0 1 0
8 7 7 9 7 7 7 7 6 7 7 7 9 6 8 7 7 7 6 7 7 9 7 6 7 7 7 7 5 6 5 6 3 2 2 2 2 4 2 2 2 2 2 2 2 2 2 2 4 3 2 2 2 2 2 2 2 2 2 4 2 2 2 2 2 2 2 1 1 4 D 1 0 1 0 C 0 1 0 1 C 1 0 1 D 1 0 1 0 1 C D 0 1 0 C 0 1 D 1
8 6 9 7 7 7 6 8 7 7 7 9 7 7 8 7 6 7 7 7 9 8 7 7 7 7 6 7 6 4 6 4 3 3 3 3 3 3 3 3 3 3 3 3 3 3 3 3 3 3 3 3 3 3 3 3 3 3 3 3 3 3 3 3 3 3 1 1 4 1 1 0 1 0 1 0 1 0 1 0 1 0 1 0 1 0 1 0 1 0 1 0 1 0 1 0 1 0 1 0
8 9 7 7 6 7 7 7 7 6 9 7 7 7 8 7 7 7 7 9 7 7 7 7 6 7 7 7 4 6 4 6 3 2 2 4 2 2 2 2 2 2 2 2 2 2 4 2 2 3 2 2 2 2 2 2 2 4 2 2 2 2 2 2 2 2 1 4 1 1 0 1 0 1 0 1 0 1 0 1 0 1 0 1 D 1 0 1 0 1 0 1 0 1 0 1 0 1 0 1
9 7 6 7 7 7 7 8 7 9 7 7 6 7 8 7 7 6 9 7 7 8 6 7 7 7 7 9 6 5 6 5 3 2 4 2 2 2 2 2 2 2 2 2 2 4 2 2 2 3 2 2 2 2 2 2 4 2 2 2 2 2 2 2 2 2 4 1 1 2 1 0 1 0 1 C 1 D 1 0 C 0 1 0 D C 1 0 1 0 1 D 1 0 1 C 1 0 1 0
8 7 7 7 7 6 7 7 9 7 6 7 7 7 8 6 7 9 7 7 6 7 7 7 7 6 9 7 4 6 4 6 3 4 2 2 2 2 2 2 2 2 2 2 4 2 2 2 2 3 2 2 2 2 2 4 2 2 2 2 2 2 2 2 2 2 1 1 2 4 0 1 0 1 0 1 0 1 0 1 0 1 0 1 D 1 0 1 0 1 0 1 0 1 0 1 0 1 0 1
8 8 8 8 8 8 8 9 8 8 8 8 8 8 8 8 9 8 8 8 8 8 8 8 8 9 8 8 6 4 6 4 3 2 2 2 B 2 2 2 2 2 B 4 2 2 2 2 B 3 2 2 2 2 4 2 2 2 2 2 B 2 2 2 2 4 1 2 4 1 1 0 1 0 1 D 1 0 D 0 1 D 1 0 1 0 1 D 1 0 D 0 1 D 1 0 1 0 1 D
8 6 7 7 7 7 9 7 7 7 7 6 7 7 8 9 6 7 7 7 7 6 7 7 9 7 6 7 5 6 5 6 3 2 2 2 2 2 2 2 2 2 4 2 2 2 2 2 2 3 2 2 2 4 2 2 2 2 2 2 2 2 2 2 4 2 2 4 1 2 D 1 0 1 0 1 0 D 0 1 C 1 0 1 D C 0 1 0 1 C 1 0 1 0 1 0 1 D 1
8 7 7 7 6 9 7 8 7 6 7 7 7 7 9 7 7 7 7 6 7 8 7 9 6 7 7 7 6 4 6 4 3 2 2 2 2 2 2 2 2 4 2 2 2 2 2 2 2 3 2 2 4 2 2 2 2 2 2 2 2 2 2 4 2 2 4 1 2 1 1 0 1 0 1 0 1 0 1 0 1 0 1 0 D 0 1 0 1 0 1 0 1 0 1 0 1 0 1 0
8 7 6 7 9 7 7 6 7 7 7 7 6 9 8 7 7 6 7 7 7 7 9 7 7 7 7 6 4 6 4 6 3 2 2 2 2 2 2 2 4 2 2 2 2 2 2 2 2 3 2 4 2 2 2 2 2 2 2 2 2 2 4 2 2 2 1 2 1 4 0 1 0 1 0 1 0 1 0 1 0 1 0 1 D 1 0 1 0 1 0 1 0 1 0 1 0 1 0 1
8 7 7 9 7 6 7 8 7 7 6 7 9 7 8 6 7 7 7 7 6 9 7 7 7 6 7 7 6 5 6 5 3 2 2 2 B 2 2 4 2 2 B 2 2 2 2 2 B 3 4 2 2 2 B 2 2 2 2 2 B 4 2 2 2 2 2 1 4 2 D 0 1 0 1 C 1 D 1 0 1 0 1 0 1 C 1 0 1 0 C D 1 0 1 C 1 0 D 0
8 7 9 6 7 7 7 7 6 7 7 9 7 6 8 7 7 7 6 7 9 7 7 6 7 7 7 7 4 6 4 6 3 2 2 2 2 2 4 2 2 2 2 2 2 2 2 2 2 3 2 2 2 2 2 2 2 2 2 2 4 2 2 2 2 2 1 4 2 1 0 1 0 1 0 1 0 1 0 1 0 1 0 1 D 1 0 1 0 1 0 1 0 1 0 1 0 1 0 1
8 9 7 7 7 7 6 8 7 7 9 6 7 7 8 7 6 7 7 9 7 8 7 7 7 7 6 7 6 4 6 4 3 2 2 2 2 4 2 2 2 2 2 2 2 2 2 2 4 3 2 2 2 2 2 2 2 2 2 4 2 2 2 2 2 2 4 2 1 1 1 0 1 0 1 0 1 0 1 0 1 0 1 0 D 0 1 0 1 0 1 0 1 0 1 0 1 0 1 0
9 7 8 7 8 7 8 7 8 9 8 7 8 7 8 7 8 7 9 6 8 7 8 7 8 7 8 9 5 6 5 6 3 2 2 2 4 2 2 2 2 2 2 2 2 2 2 4 2 3 2 2 2 2 2 2 2 2 4 2 2 2 2 2 2 2 2 1 1 4 D D D 1 D D D 1 D D D 1 D D D 1 D D D 1 D D D 1 D D D 1 D D
8 7 6 7 7 7 7 8 9 7 7 7 6 7 8 7 7 9 7 7 7 8 6 7 7 7 9 6 6 4 6 4 3 2 2 4 B 2 2 2 2 2 B 2 2 2 4 2 B 3 2 2 2 2 B 2 2 4 2 2 B 2 2 2 2 2 1 1 4 1 1 0 1 0 1 0 1 0 1 0 1 0 1 0 1 E E E E E E E 1 0 1 0 1 0 1 0
8 7 7 7 7 6 7 9 7 7 6 7 7 7 8 6 9 7 7 7 6 7 7 7 7 9 7 7 4 6 4 6 3 2 4 2 2 2 2 2 2 2 2 2 2 4 2 2 2 3 2 2 2 2 2 2 4 2 2 2 2 2 2 2 2 2 1 4 1 1 0 1 0 1 0 1 0 1 0 1 0 1 0 E E E E E E E E E E E 0 1 0 1 0 1
8 7 7 6 7 7 9 8 6 7 7 7 7 6 8 9 7 7 6 7 7 8 7 6 9 7 7 7 6 5 6 5 3 4 2 2 2 2 2 2 2 2 2 2 4 2 2 2 2 3 2 2 2 2 2 4 2 2 2 2 2 2 2 2 2 2 4 1 1 2 1 0 1 0 1 C 1 D 1 0 C 0 E E E E E E E E E E E E E C 1 0 1 0
8 6 7 7 7 9 6 7 7 7 7 6 7 7 9 7 6 7 7 7 7 6 7 9 7 7 6 7 4 6 4 6 3 2 2 2 2 2 2 2 2 2 2 4 2 2 2 2 2 3 2 2 2 2 4 2 2 2 2 2 2 2 2 2 2 4 1 1 2 4 0 1 0 1 0 1 0 1 0 1 0 E E E E E E E E E E E E E E E 0 1 0 1
8 7 7 7 9 7 7 8 7 6 7 7 7 9 8 7 7 7 7 6 7 8 9 7 6 7 7 7 6 4 6 4 3 2 2 2 B 2 2 2 2 2 4 2 2 2 2 2 B 3 2 2 2 4 B 2 2 2 2 2 B 2 2 2 4 2 1 2 4 1 1 0 1 0 1 0 1 0 1 0 E E E E E E E E E E E E E E E E E 0 1 0
8 7 6 9 7 7 7 6 7 7 7 7 9 7 8 7 7 6 7 7 7 9 6 7 7 7 7 6 5 6 5 6 3 3 3 3 3 3 3 3 3 3 3 3 3 3 3 3 3 3 3 3 3 3 3 3 3 3 3 3 3 3 3 3 3 3 2 4 1 2 D 1 0 1 0 1 0 D 0 E E E E E E E E E E E E E E E E E E E D 1
8 8 9 8 8 8 8 8 8 8 8 9 8 8 8 8 8 8 8 8 9 8 8 8 8 8 8 8 6 4 6 4 3 2 2 2 2 2 2 2 4 2 2 2 2 2 2 2 2 3 2 4 2 2 2 2 2 2 2 2 2 2 4 2 2 2 4 1 2 1 1 0 D 0 1 D 1 0 1 E E E E E E E E E E E E E E E E E E E 1 D
8 9 7 6 7 7 7 7 6 7 9 7 7 6 8 7 7 7 6 9 7 7 7 6 7 7 7 7 4 6 4 6 3 2 2 2 2 2 2 4 2 2 2 2 2 2 2 2 2 3 4 2 2 2 2 2 2 2 2 2 2 4 2 2 2 2 1 2 1 4 0 1 0 1 0 1 0 1 E E E E E E E E E E E E E E E E E E E E E 1
9 6 7 7 7 7 6 8 7 9 7 6 7 7 8 7 6 7 9 7 7 8 7 7 7 7 6 9 6 5 6 5 3 2 2 2 B 2 4 2 2 2 B 2 2 2 2 2 B 3 2 2 2 2 B 2 2 2 2 2 4 2 2 2 2 2 2 1 4 2 D 0 1 0 1 C 1 D E E E E E E E E E E E E E E E E E E E E E 0
8 7 7 7 6 7 7 7 9 6 7 7 7 7 8 7 7 9 7 6 7 7 7 7 6 7 9 7 4 6 4 6 3 2 2 2 2 4 2 2 2 2 2 2 2 2 2 2 4 3 2 2 2 2 2 2 2 2 2 4 2 2 2 2 2 2 1 4 2 1 0 1 0 1 0 1 0 1 E E E E E E E E E E E E E E E E E E E E E 1
8 7 6 7 7 7 7 9 7 7 7 7 6 7 8 7 9 6 7 7 7 8 6 7 7 9 7 6 6 4 6 4 3 2 2 2 4 2 2 2 2 2 2 2 2 2 2 4 2 3 2 2 2 2 2 2 2 2 4 2 2 2 2 2 2 2 4 2 1 1 1 0 1 0 1 0 1 0 E E E E E E E E E E E E E E E E E E E E E 0
8 7 7 7 7 6 9 7 7 7 6 7 7 7 8 9 7 7 7 7 6 7 7 7 9 6 7 7 5 6 5 6 3 2 2 4 2 2 2 2 2 2 2 2 2 2 4 2 2 3 2 2 2 2 2 2 2 4 2 2 2 2 2 2 2 2 2 1 1 4 D 1 0 1 0 C 0 1 E E E E E E E E E E E E E E E E E E E E E 1
8 7 7 6 7 9 7 8 6 7 7 7 7 6 9 7 7 7 6 7 7 8 7 9 7 7 7 7 6 4 6 4 3 2 4 2 B 2 2 2 2 2 B 2 2 4 2 2 B 3 2 2 2 2 B 2 4 2 2 2 B 2 2 2 2 2 1 1 4 1 1 0 1 0 1 0 1 0 E E E E E E E E E E E E E E E E E E E E E 0
8 6 8 7 9 7 8 7 8 7 8 6 8 9 8 7 8 7 8 7 8 6 9 7 8 7 8 7 4 6 4 6 3 4 2 2 2 2 2 2 2 2 2 2 4 2 2 2 2 3 2 2 2 2 2 4 2 2 2 2 2 2 2 2 2 2 1 4 1 1 0 1 D 1 0 1 0 1 E E E E E E E E E E E E E E E E E E E E E 1
8 7 7 9 6 7 7 8 7 6 7 7 9 7 8 7 7 7 7 6 7 9 7 7 6 7 7 7 6 5 6 5 3 2 2 2 2 2 2 2 2 2 2 4 2 2 2 2 2 3 2 2 2 2 4 2 2 2 2 2 2 2 2 2 2 4 4 1 1 2 1 0 1 0 1 C 1 D 1 E E E E E E E E E E E E E E E E E E E 1 0
8 7 9 7 7 7 7 6 7 7 7 9 6 7 8 7 7 6 7 7 9 7 6 7 7 7 7 6 4 6 4 6 3 2 2 2 2 2 2 2 2 2 4 2 2 2 2 2 2 3 2 2 2 4 2 2 2 2 2 2 2 2 2 2 4 2 1 1 2 4 0 1 0 1 0 1 0 1 0 E E E E E E E E E E E E E E E E E E E 0 1
8 9 7 7 7 6 7 8 7 7 9 7 7 7 8 6 7 7 7 9 6 8 7 7 7 6 7 7 6 4 6 4 3 2 2 2 B 2 2 2 2 4 B 2 2 2 2 2 B 3 2 2 4 2 B 2 2 2 2 2 B 2 2 4 2 2 1 2 4 1 1 0 1 0 1 0 1 0 1 0 E E E E E E E E E E E E E E E E E 0 1 0
9 7 7 6 7 7 7 7 6 9 7 7 7 6 8 7 7 7 9 7 7 7 7 6 7 7 7 9 5 6 5 6 3 2 2 2 2 2 2 2 4 2 2 2 2 2 2 2 2 3 2 4 2 2 2 2 2 2 2 2 2 2 4 2 2 2 2 4 1 2 D 1 0 1 0 1 0 D 0 1 C E E E E E E E E E E E E E E E 0 1 D 1
8 6 7 7 7 7 6 8 9 7 7 6 7 7 8 7 6 9 7 7 7 8 7 7 7 7 9 7 6 4 6 4 3 2 2 2 2 2 2 4 2 2 2 2 2 2 2 2 2 3 4 2 2 2 2 2 2 2 2 2 2 4 2 2 2 2 4 1 2 1 1 0 1 0 1 0 1 0 1 0 1 0 E E E E E E E E E E E E E 0 1 0 1 0
8 7 7 7 6 7 7 9 7 6 7 7 7 7 8 7 9 7 7 6 7 7 7 7 6 9 7 7 4 6 4 6 3 2 2 2 2 2 4 2 2 2 2 2 2 2 2 2 2 3 2 2 2 2 2 2 2 2 2 2 4 2 2 2 2 2 1 2 1 4 0 1 0 1 0 1 0 1 0 1 0 1 0 E E E E E E E E E E E 0 1 0 1 0 1
8 8 8 8 8 8 9 8 8 8 8 8 8 8 8 9 8 8 8 8 8 8 8 8 9 8 8 8 6 5 6 5 3 2 2 2 B 4 2 2 2 2 B 2 2 2 2 2 4 3 2 2 2 2 B 2 2 2 2 4 B 2 2 2 2 2 2 1 4 2 D D 1 D D D 1 D D D 1 D D D 1 E E E E E E E 1 D D D 1 D D D
8 7 7 7 7 9 7 7 7 7 6 7 7 7 9 6 7 7 7 7 6 7 7 9 7 6 7 7 4 6 4 6 3 2 2 2 4 2 2 2 2 2 2 2 2 2 2 4 2 3 2 2 2 2 2 2 2 2 4 2 2 2 2 2 2 2 1 4 2 1 0 1 0 1 0 1 0 1 0 1 0 1 0 1 D 1 0 1 0 1 0 1 0 1 0 1 0 1 0 1
8 7 7 6 9 7 7 8 6 7 7 7 7 9 8 7 7 7 6 7 7 8 9 6 7 7 7 7 6 4 6 4 3 3 3 3 3 3 3 3 3 3 3 3 3 3 3 3 3 3 3 3 3 3 3 3 3 3 3 3 3 3 3 3 3 3 4 2 1 1 1 0 1 0 1 0 1 0 1 0 1 0 1 0 D 0 1 0 1 0 1 0 1 0 1 0 1 0 1 0
8 6 7 9 7 7 6 7 7 7 7 6 9 7 8 7 6 7 7 7 7 9 7 7 7 7 6 7 5 6 5 6 3 2 4 2 2 2 2 2 2 2 2 2 2 4 2 2 2 3 2 2 2 2 2 2 4 2 2 2 2 2 2 2 2 2 2 1 1 4 D 1 0 1 0 C 0 1 0 1 C 1 0 1 D 1 0 1 0 1 C D 0 1 0 C 0 1 D 1
8 7 9 7 6 7 7 8 7 6 7 9 7 7 8 7 7 7 7 6 9 8 7 7 6 7 7 7 6 4 6 4 3 4 2 2 B 2 2 2 2 2 B 2 4 2 2 2 B 3 2 2 2 2 B 4 2 2 2 2 B 2 2 2 2 2 1 1 4 1 1 0 1 0 1 0 1 0 1 0 1 0 1 0 1 0 1 0 1 0 1 0 1 0 1 0 1 0 1 0
8 9 6 7 7 7 7 6 7 7 9 7 6 7 8 7 7 6 7 9 7 7 6 7 7 7 7 6 4 6 4 6 3 2 2 2 2 2 2 2 2 2 2 4 2 2 2 2 2 3 2 2 2 2 4 2 2 2 2 2 2 2 2 2 2 4 1 4 1 1 0 1 0 1 0 1 0 1 0 1 0 1 0 1 D 1 0 1 0 1 0 1 0 1 0 1 0 1 0 1
9 7 7 7 7 6 7 8 7 9 6 7 7 7 8 6 7 7 9 7 6 8 7 7 7 6 7 9 6 5 6 5 3 2 2 2 2 2 2 2 2 2 4 2 2 2 2 2 2 3 2 2 2 4 2 2 2 2 2 2 2 2 2 2 4 2 4 1 1 2 1 0 1 0 1 C 1 D 1 0 C 0 1 0 D C 1 0 1 0 1 D 1 0 1 C 1 0 1 0
8 7 8 6 8 7 8 7 9 7 8 7 8 6 8 7 8 9 8 7 8 7 8 6 8 7 9 7 4 6 4 6 3 2 2 2 2 2 2 2 2 4 2 2 2 2 2 2 2 3 2 2 4 2 2 2 2 2 2 2 2 2 2 4 2 2 1 1 2 4 0 1 D 1 0 D 0 1 D 1 0 1 0 1 D 1 0 D 0 1 D 1 0 1 0 1 D 1 0 D
8 6 7 7 7 7 6 9 7 7 7 6 7 7 8 7 9 7 7 7 7 8 7 7 7 9 6 7 6 4 6 4 3 2 2 2 B 2 2 2 4 2 B 2 2 2 2 2 B 3 2 4 2 2 B 2 2 2 2 2 B 2 4 2 2 2 1 2 4 1 1 0 1 0 1 0 1 0 1 0 1 0 1 0 1 0 1 0 1 0 1 0 1 0 1 0 1 0 1 0
8 7 7 7 6 7 9 7 7 6 7 7 7 7 8 9 7 7 7 6 7 7 7 7 9 7 7 7 5 6 5 6 3 2 2 2 2 2 2 4 2 2 2 2 2 2 2 2 2 3 4 2 2 2 2 2 2 2 2 2 2 4 2 2 2 2 2 4 1 2 D 1 0 1 0 1 0 D 0 1 C 1 0 1 D C 0 1 0 1 C 1 0 1 0 1 0 1 D 1
8 7 6 7 7 9 7 8 7 7 7 7 6 7 9 7 7 6 7 7 7 8 6 9 7 7 7 6 6 4 6 4 3 2 2 2 2 2 4 2 2 2 2 2 2 2 2 2 2 3 2 2 2 2 2 2 2 2 2 2 4 2 2 2 2 2 4 1 2 1 1 0 1 0 1 0 1 0 1 0 1 0 1 0 D 0 1 0 1 0 1 0 1 0 1 0 1 0 1 0
8 7 7 7 9 6 7 7 7 7 6 7 7 9 8 6 7 7 7 7 6 7 9 7 7 6 7 7 4 6 4 6 3 2 2 2 2 4 2 2 2 2 2 2 2 2 2 2 4 3 2 2 2 2 2 2 2 2 2 4 2 2 2 2 2 2 1 2 1 4 0 1 0 1 0 1 0 1 0 1 0 1 0 1 D 1 0 1 0 1 0 1 0 1 0 1 0 1 0 1
8 7 7 9 7 7 7 8 6 7 7 7 9 6 8 7 7 7 6 7 7 9 7 6 7 7 7 7 6 5 6 5 3 2 2 2 4 2 2 2 2 2 B 2 2 2 2 4 B 3 2 2 2 2 B 2 2 2 4 2 B 2 2 2 2 2 2 1 4 2 D 0 1 0 1 C 1 D 1 0 1 0 1 0 1 C 1 0 1 0 C D 1 0 1 C 1 0 D 0
8 6 9 7 7 7 6 7 7 7 7 9 7 7 8 7 6 7 7 7 9 6 7 7 7 7 6 7 4 6 4 6 3 2 2 4 2 2 2 2 2 2 2 2 2 2 4 2 2 3 2 2 2 2 2 2 2 4 2 2 2 2 2 2 2 2 1 4 2 1 0 1 0 1 0 1 0 1 0 1 0 1 0 1 D 1 0 1 0 1 0 1 0 1 0 1 0 1 0 1
8 9 8 8 8 8 8 8 8 8 9 8 8 8 8 8 8 8 8 9 8 8 8 8 8 8 8 8 6 4 6 4 3 2 4 2 2 2 2 2 2 2 2 2 2 4 2 2 2 3 2 2 2 2 2 2 4 2 2 2 2 2 2 2 2 2 4 2 1 1 1 0 D 0 1 D 1 0 1 0 1 D 1 0 D 0 1 D 1 0 1 0 1 D 1 0 D 0 1 D
9 7 6 7 7 7 7 6 7 9 7 7 6 7 8 7 7 6 9 7 7 7 6 7 7 7 7 9 5 6 5 6 3 4 2 2 2 2 2 2 2 2 2 2 4 2 2 2 2 3 2 2 2 2 2 4 2 2 2 2 2 2 2 2 2 2 2 1 1 4 D 1 0 1 0 C 0 1 0 1 C 1 0 1 D 1 0 1 0 1 C D 0 1 0 C 0 1 D 1
R 8 12 1 5
R 16 34 1 4
R 22 52 1 5
R 10 70 1 4
R 26 88 1 5
R 38 16 2 4
R 44 38 2 5
R 50 58 2 4
R 56 74 2 5
R 62 90 2 4
R 72 20 3 4
R 78 44 3 5
R 84 62 3 4
R 90 78 3 5
R 96 94 3 4
