90 90
0 0 0 0 3 0 0 0 0 0 0 2 0 0 0 2 0 2 0 0 0 0 0 3 2 A C C C C C C C C C C C C C C C C C C D C C C C E C C C C C C C C C A A A A A 4 4 5 4 4 4 4 4 4 4 4 4 4 5 7 4 4 4 4 4 4 4 4 4 5 4
0 0 3 0 0 0 0 0 0 2 0 0 1 1 1 0 0 0 0 0 0 3 0 2 2 A C C C C C C C C C C C C C C C C C D C C C C C C C C C C C C C C C A A A A A 5 4 4 4 4 4 4 4 4 4 4 5 4 4 4 4 4 4 4 4 4 4 5 4 4 4
3 2 0 0 0 0 0 0 0 0 0 0 2 1 1 1 2 0 0 3 0 0 0 2 2 A C C C C E C C C C C C C C C C C D C C C C C C C C C C C B C C C A A A A A 4 4 4 4 4 4 4 4 4 4 5 4 7 4 4 4 4 4 4 4 4 5 4 4 4 4 4
0 0 0 0 0 0 0 0 0 0 0 0 0 0 0 0 2 3 0 0 0 0 0 0 2 2 A C C C C C C C C C C C C C C D C B E C C C C C C C C C C C C C A A A A A 4 4 4 4 4 4 4 4 5 4 4 4 4 4 4 4 4 4 4 5 4 4 4 4 4 4 4
0 0 0 0 0 0 0 0 2 0 0 0 0 0 2 1 1 1 2 0 0 0 0 0 2 2 A C C C C C B C C C C C C C D C C C C C C C C C C C C C C C C C A A A A A 4 4 4 4 4 4 5 6 4 7 4 4 4 4 4 4 4 5 4 4 4 4 4 4 4 4 4
2 0 0 0 0 0 0 0 0 0 0 0 0 3 0 1 1 1 0 0 0 0 0 2 2 2 A C C C C C C C C C C C C D C C C C C C C C C C C C C C C C C C A A A A A 4 4 4 4 5 6 6 6 6 6 4 4 4 4 4 5 4 4 4 4 4 4 4 4 4 4 7
0 0 0 0 0 0 0 0 0 0 0 3 0 0 0 2 0 0 0 2 0 0 0 0 0 2 2 A C C C C C C C C C C D E C C C C C C C C C C C C C C C C C C A A A A A 4 4 5 4 6 6 6 6 6 6 6 4 4 5 4 4 4 4 4 4 4 4 4 4 5 4 4
0 0 0 0 0 0 0 2 0 3 0 0 0 0 0 0 0 1 1 1 0 0 0 0 0 2 2 A C C C C C C C C C D C C C C C C C C C C C C C C B E C C C A A A A A 4 5 4 5 4 6 6 6 6 6 6 6 5 4 4 4 4 4 4 4 4 4 4 5 7 4 4 4
0 0 0 0 0 0 0 3 0 0 0 0 0 0 0 0 2 1 1 1 2 0 2 0 0 2 3 A C C C C C C C C D C C C C B C C C C C C C C C C C C C C C A A A A A 5 5 5 5 6 6 6 6 6 6 6 6 6 4 4 4 4 4 4 4 4 5 4 4 4 4 4 4
0 0 0 0 0 3 0 0 0 0 0 0 0 0 2 0 0 0 0 0 0 0 0 0 3 2 2 A C C B C C C E D C C C C C C C C C C C C C C C C C C C C C A A A A A 5 5 5 5 5 6 6 6 6 6 6 6 4 4 4 4 4 4 4 5 4 7 4 4 4 4 4 4
0 0 0 3 0 0 2 0 0 0 0 0 0 0 0 0 2 1 1 1 2 0 3 0 0 0 2 2 A C C C C C D C C C C C C C C C C C C C E C C C C C C C D A A A A A 5 7 5 5 5 6 6 6 6 6 6 6 4 4 4 4 4 5 4 4 4 4 4 4 4 4 4 4
0 3 0 0 0 0 0 0 0 0 0 0 0 0 0 0 0 1 1 1 3 2 0 0 0 0 2 2 A C C C C D C C C C C C C C C C C C C C C C C C C C C D A A A A A 5 5 5 5 5 5 5 6 6 6 6 6 4 4 4 4 5 4 4 7 4 4 4 4 4 4 4 5 4
0 0 0 0 0 0 0 0 0 0 0 0 0 2 0 0 2 0 3 0 2 0 0 0 0 0 2 2 A E C C D C C C C C C C C C C C C C C C C C B C C C D C A A A A A 5 5 5 5 5 5 5 5 5 6 4 4 4 4 5 4 4 4 4 4 4 4 4 4 4 5 4 4 4
0 0 0 0 0 2 0 0 0 0 0 0 0 0 0 0 1 1 1 0 0 0 0 0 0 0 2 2 A C C D C C C C C C C B C C C E C C C C C C C C C D C C A A A A A 5 5 5 5 5 5 5 5 5 4 4 4 5 4 4 4 7 4 4 4 4 4 4 5 4 4 4 4 4
0 0 0 0 0 0 0 0 0 0 0 0 0 1 1 2 1 1 1 2 2 0 0 0 0 0 0 2 2 A D C C C C C C C C C C C C C C C C C C C C C D C C C A A A A A 5 5 5 5 5 5 5 5 5 4 5 4 4 4 4 4 4 4 4 4 4 5 4 4 4 4 4 4 4
0 0 0 0 0 0 0 0 0 0 0 1 1 1 1 1 1 1 0 0 0 0 0 0 0 0 0 2 2 A C C C C C C C C C C C C C C C C C C C C C D C C C C A A A A A 5 5 5 5 5 5 5 5 5 4 4 4 4 7 4 4 4 4 4 5 4 4 4 4 4 4 4 4 4
0 0 0 0 2 0 0 0 0 0 3 1 1 1 2 1 1 1 2 0 0 0 0 0 0 0 0 2 2 A C C C C C C C C E C C C C C C C C C C C D C C C C C A A A A A 4 5 5 5 5 5 5 8 8 8 8 9 8 8 8 8 4 5 4 4 4 4 4 4 4 4 4 4 5
0 0 0 0 0 0 0 0 3 0 1 1 1 1 1 1 1 1 1 2 0 0 0 0 0 0 0 3 2 A C C C C C C C C C C C C C C C C C C B D C C E C C C A A A A A 4 4 4 4 5 8 8 9 9 9 9 9 9 9 9 9 8 8 4 4 4 4 4 4 4 4 5 4 4
0 0 0 0 0 0 3 0 0 0 1 1 1 2 1 1 1 2 1 0 0 0 0 0 0 3 0 2 2 A C C C C C C C B C C C C C C C C C C D C C C C C C A A A A A 4 4 4 5 4 8 9 9 9 9 9 9 9 9 9 9 9 9 9 8 4 4 4 4 4 5 4 4 7 4
0 0 0 2 3 0 0 0 0 0 1 1 1 1 1 1 1 1 1 0 0 0 0 3 0 0 2 2 2 A C C C E C C C C C C C C C C C C C D C C C C C C C A A A A A 4 5 4 4 4 8 9 9 9 9 9 9 9 9 9 9 9 9 9 8 4 4 4 5 4 4 4 4 4 4
0 0 3 0 0 0 0 0 0 0 0 2 1 1 1 2 1 1 2 0 0 3 0 0 0 0 0 2 2 A C C C C C C C C C C C C C C C C D E C C C C C C C A A A A A 4 4 4 4 8 9 9 9 9 9 9 9 9 9 9 9 9 9 9 9 8 5 4 4 4 7 4 4 4 4
3 0 0 0 0 0 0 0 0 0 2 1 1 1 1 1 1 1 0 3 0 0 0 0 0 0 0 2 2 A C C C C C C C C C E E E C C C D C C C C C C C C C A A A A A 4 4 4 4 4 8 9 9 9 9 9 9 9 9 9 9 9 9 9 8 4 4 4 4 4 4 4 4 4 4
0 0 2 0 0 0 0 0 0 0 2 1 1 1 2 1 0 3 0 0 0 0 0 0 0 2 0 2 2 A C C C C C C C C E E E E E C D C B C C C C C C C A A A A A 4 4 4 4 4 4 8 9 9 9 9 9 9 9 9 9 9 9 9 9 8 4 4 7 4 4 4 4 4 5 4
0 0 0 0 0 0 0 0 0 0 0 1 1 1 0 3 0 2 0 0 0 0 0 0 0 0 0 2 2 A C C C C C B C E E E E E E D C C C C C C C C C C A A A A A 4 4 4 7 4 5 4 8 8 9 9 9 9 9 9 9 9 9 8 8 5 5 5 5 5 5 5 5 4 4 4
0 0 0 0 0 0 0 0 0 2 0 0 0 2 0 0 0 0 0 0 0 0 0 0 0 0 0 2 2 A C C C C C C E E E E E E D E E C C C C C C C C C A A A A A 4 4 4 5 4 4 4 4 4 8 8 8 8 9 8 8 8 8 4 5 7 5 5 5 5 5 5 5 4 4 4
0 2 0 0 0 0 0 0 0 0 1 1 1 0 0 0 0 0 0 0 0 0 0 0 2 0 0 2 2 A C C C C C C E E E E E D E E E C C C C C C C C C A A A A A 7 5 4 4 4 4 4 4 4 5 4 4 5 4 4 4 4 4 5 5 5 5 5 5 5 5 5 5 5 4 4
0 0 0 0 0 0 0 0 0 2 1 1 1 2 0 0 2 0 0 0 0 0 0 0 0 0 0 2 3 A C C C C C C E E E E D E E E E C C C C C C C C C A A A A A 4 4 4 4 4 4 5 5 5 5 5 5 5 4 4 4 4 7 5 5 5 5 5 5 5 5 5 5 5 4 4
0 0 0 0 0 0 0 3 2 0 0 0 0 0 0 0 0 0 0 0 0 0 0 0 0 0 3 2 2 A C C C C C C C E E D E E E E B C C C C C C E C A A A A A 4 4 4 4 4 4 5 5 5 5 5 5 5 5 5 4 4 4 4 5 5 5 5 5 5 5 5 5 5 5 4 5
2 0 0 0 0 3 0 0 0 2 1 1 1 2 0 0 0 0 0 0 0 0 0 2 3 0 0 2 2 A C C C B C C C C D E E E E C C C C C C C C C C A A A A A 4 4 4 4 4 5 5 5 5 5 5 5 5 5 5 7 4 4 5 5 5 5 5 5 5 5 5 5 5 5 5 4
0 0 0 3 0 0 0 0 0 0 1 1 1 0 0 2 0 0 0 0 0 0 3 0 0 0 0 2 2 A C C E C C C C D C E E E C C C C C C C C C C C A A A A A 4 4 4 4 5 5 5 5 5 5 5 5 5 5 5 5 5 4 4 5 5 5 5 5 5 5 5 5 5 5 4 4
0 3 0 0 0 0 0 2 0 0 2 0 0 0 2 0 0 0 0 0 3 0 0 0 0 0 0 2 2 A C C C C C C D C C C C C C C C C E C C C C C C A A A A A 4 4 4 5 5 5 5 5 5 5 5 5 7 5 5 5 5 4 4 5 5 5 5 5 5 5 5 5 5 5 4 4
0 0 0 0 0 0 0 0 0 0 0 1 1 1 0 0 0 0 3 0 0 0 2 0 0 0 0 2 2 A C C C C C D C C C C C C C C C C C C C C C C C A A A A A 4 5 4 4 5 5 5 5 5 5 5 5 5 5 5 5 5 4 4 5 5 5 5 5 5 5 5 5 5 7 4 4
0 0 0 0 0 0 0 0 0 0 2 1 1 1 2 0 3 0 0 0 0 0 0 0 0 0 2 2 A C C C C C D C C C C C C C B C C C C C C C C C C A A A A A 4 4 4 5 5 5 5 5 5 7 5 5 5 5 5 5 5 5 4 4 5 5 5 5 5 5 5 5 5 4 4 4
0 0 0 0 0 0 2 0 0 0 0 0 0 0 3 0 0 0 0 0 0 0 0 0 0 0 2 2 A C C B C D C C C C C C C E C C C C C C C C C C C A A A A A 4 4 4 4 5 5 5 5 5 5 5 5 5 5 5 5 5 4 4 5 4 5 5 5 5 5 7 5 4 4 5 4
0 0 0 0 0 0 0 0 0 0 0 0 2 1 1 1 2 0 0 0 0 2 0 0 0 0 2 2 A C C C D C C C C C C C C C C C C C C C C C C C C A A A A A 4 4 4 4 5 5 7 5 5 5 5 5 5 5 5 5 5 5 4 4 4 4 4 4 5 4 4 4 5 4 4 4
0 0 0 0 0 0 0 0 0 0 3 0 0 1 1 1 0 0 0 0 0 0 0 0 0 0 2 2 A C C D C C C C C C C C C C C C C C C C C C C C C A A A A A 4 4 4 4 5 5 5 5 5 5 5 5 5 5 5 5 5 4 4 4 4 4 4 7 4 4 5 4 6 4 4 4
0 0 0 0 0 2 0 0 3 0 0 0 0 2 0 0 0 2 0 0 0 0 0 0 0 2 2 A C C D C C C C C E C C C C C C C C C C C C C C B D A A A A A 4 4 5 7 4 5 5 5 5 5 5 5 5 5 5 5 4 4 4 4 4 4 4 4 5 6 6 6 6 6 6 6
0 0 0 0 0 0 3 0 0 0 0 0 0 0 1 1 1 0 0 0 2 0 0 0 0 3 2 A C D C C C C C C C C C C B C C C C C C C C C E D C A A A A A 5 4 4 4 4 4 5 5 5 5 5 5 5 5 5 4 4 4 4 4 7 4 5 4 6 6 6 6 6 6 6 6
0 0 0 0 3 0 0 0 0 0 0 0 2 0 2 1 1 1 2 0 0 0 0 3 0 2 2 A D B C C C C C C C C C C C C C C C C C C C C D C C A A A A A 7 4 4 4 4 4 4 5 5 5 5 5 5 5 4 4 4 4 4 4 5 4 4 4 6 6 6 6 6 6 6 6
0 0 3 0 2 0 0 0 0 0 0 0 0 0 0 0 0 0 0 0 0 3 0 0 0 2 2 A C C C E C C C C C C C C C C C C C C C C C D C C C A A A A A 4 4 4 4 4 4 4 5 4 4 5 4 4 4 4 4 4 7 5 4 4 4 4 4 6 6 6 6 6 6 6 6
3 0 0 0 0 0 0 0 0 0 0 0 0 0 2 1 1 1 2 3 0 0 0 0 2 2 A C C C C C C C C C C C C C C C C C C E C C D C C C C A A A A A 4 4 4 4 4 5 4 4 4 4 4 4 4 4 4 4 5 4 4 4 4 4 4 6 6 6 6 6 6 6 6 6
0 0 0 0 0 0 0 0 0 0 0 2 0 0 0 0 1 1 1 0 0 0 0 0 2 2 A C C C C C C C C C C C C C C C C C C C C D C B C C C A A A A A 4 4 4 5 4 4 4 4 4 4 4 4 4 4 7 4 4 4 4 4 4 4 4 4 6 6 6 6 6 6 6 6
0 0 0 2 0 0 0 0 0 0 0 0 0 0 0 2 0 0 0 2 0 0 0 0 2 2 A C C C C C C C C C C C B C C C C C C C D C C C C C C A A A A A 4 5 4 4 4 4 4 4 4 4 4 4 5 4 4 4 4 4 4 4 4 4 4 5 6 6 6 6 6 6 6 6
0 0 0 0 0 0 0 0 0 0 0 0 0 3 0 0 1 1 1 0 0 0 0 2 2 A C B C C C C C C C C C C C C E C C C C D C C C C C C C A A A A A 4 4 4 4 4 4 4 4 4 4 5 7 4 4 4 4 8 8 8 8 9 8 8 8 8 6 6 6 6 6 6 6
0 0 0 0 0 0 0 0 0 0 2 3 0 0 0 2 1 1 1 2 0 0 0 2 2 A C C C C C C C C C C C C C C C C C C D C C C C C C C C A A A A A 4 4 4 4 4 4 4 4 5 4 4 4 4 4 8 8 9 9 9 9 9 9 9 9 9 8 8 6 6 6 6 6
0 0 2 0 0 0 0 0 0 3 0 0 0 0 0 0 0 0 0 0 0 0 0 2 2 A C C C C C C C C C C C C C C C C C D C C C C C C C C C A A A A A 4 4 4 4 4 4 5 4 7 4 4 4 4 8 9 9 9 9 9 9 9 9 9 9 9 9 9 8 6 4 4 4
0 0 0 0 0 0 0 3 0 0 0 0 0 0 2 1 1 1 2 0 0 0 0 2 2 A C C C C C C C C C E C C C C C C D C C C C B C C C C C A A A A A 4 4 4 4 5 4 4 4 4 4 4 4 8 9 9 9 9 9 9 9 9 9 9 9 9 9 9 9 8 4 4 4
0 0 0 0 0 3 0 0 0 2 0 0 0 0 0 1 1 1 0 0 0 0 0 2 3 A C C C C C C C C C C B C C C C D C C C C C C C E C C C C A A A A A 4 5 4 4 7 4 4 4 4 4 8 8 9 9 9 9 9 9 9 9 9 9 9 9 9 9 9 8 8 4 4
0 2 0 3 0 0 0 0 0 0 0 0 0 2 0 0 0 2 0 0 0 0 3 2 A B C C C C C C C C C C C C C C D C C C C C C C C C C C C C A A A A A 4 4 4 4 4 4 4 4 4 4 8 9 9 9 9 9 9 9 9 9 9 9 9 9 9 9 9 9 8 4 4
0 3 0 0 0 0 0 0 0 0 0 0 0 1 1 1 2 0 0 0 3 0 2 2 A C C C C C E C C C C C C C C D C C C C C C C C C C C C C C A A A A A 4 7 4 4 4 4 4 4 5 4 8 8 9 9 9 9 9 9 9 9 9 9 9 9 9 9 9 8 8 4 5
0 0 0 0 0 0 0 0 2 0 0 0 2 1 1 1 2 0 3 0 0 0 2 2 A C C C C C C C C C C C C C D C C C C C E C C C C C C C C C A A A A A 4 4 4 4 4 4 5 4 4 4 4 8 9 9 9 9 9 9 9 9 9 9 9 9 9 9 9 8 5 4 4
2 0 0 0 0 0 0 0 0 0 0 0 0 0 0 0 3 0 0 0 0 2 2 A C C C C C C C C C C C C C D C C C C C C C B C C C C C C C C A A A A A 4 4 4 4 5 4 4 4 4 4 4 4 8 9 9 9 9 9 9 9 9 9 9 9 9 9 8 4 4 4 4
0 0 0 0 0 0 0 0 0 0 2 1 1 1 2 2 0 0 0 0 0 2 2 A C E C C C C C C C C B D D D D D C C C C C C C C C C C C C C C A A A A A 4 5 4 4 4 4 4 4 4 4 4 4 8 8 9 9 9 9 9 9 9 9 9 8 8 4 4 4 4 4
0 0 0 0 0 0 0 2 0 0 1 1 1 0 0 0 0 0 0 0 0 2 2 A C C C C C C C C C C D D D D D E D C C C C C C C C C C C C C C A A A A A 4 4 4 4 4 4 4 4 4 4 5 4 4 4 8 8 8 8 9 8 8 8 8 4 4 4 4 4 4 4
0 0 0 0 0 0 0 0 2 0 3 0 2 0 0 0 0 0 0 0 0 2 2 A C C C C C C C C C C D D D D D D D C C C C C C C C C C C C E C A A A A A 4 4 4 4 4 4 4 4 5 4 4 7 4 4 4 4 4 4 4 5 4 4 4 4 4 4 4 4 4 4
0 0 0 0 0 0 0 0 1 1 1 0 0 0 2 0 0 0 0 0 2 2 A C C C C C C C C C C D D D D D D D D C C C C C C C C C C C C C B A A A A A 4 4 4 4 4 4 5 4 4 4 4 4 4 4 5 4 4 5 4 4 4 4 4 4 4 4 4 4 7 4
0 0 0 0 0 0 3 2 1 1 1 2 0 0 0 0 0 0 0 0 2 2 A C C C C C C C C C D C E D D D D D D C C B C C C C C C C C C C D C A A A A A 4 4 4 5 4 4 4 7 4 5 5 5 5 5 5 5 5 5 4 4 4 4 4 4 4 5 4 4 4
0 0 0 0 3 0 1 1 1 1 1 1 1 1 1 0 0 0 0 0 2 2 A C C C C C C C C D B C D D D D D D D C C C C C C C E C C C C D C C A A A A A 4 5 4 4 4 4 4 4 5 5 5 5 5 5 5 5 5 5 5 4 4 4 4 5 7 4 4 4 4
0 0 3 0 0 0 2 1 1 1 2 0 0 2 0 0 0 0 0 0 2 3 A C C C C C C C D C C C C D D D D D C C C C C C C C C C C C D C C C A A A A A 4 4 4 4 7 4 4 5 5 5 5 5 5 5 5 5 5 5 5 5 4 5 4 4 4 4 4 4 4
3 0 0 0 0 2 1 1 1 1 1 1 1 1 1 0 0 0 0 3 2 A C C C C C C C D C C C C C C C C C C C C C C C C C C C C C D C C C C A A A A A 4 4 4 4 4 4 5 5 5 5 5 5 5 5 5 5 5 5 5 5 5 7 4 4 4 4 4 4 4
0 0 0 0 0 2 0 0 0 2 0 0 0 0 0 0 0 3 0 2 2 A C C C C C C D C C C C C C C C C C C C C C E C C C C C C D C B C C C A A A A A 4 7 4 4 4 5 5 5 5 5 5 5 5 5 5 5 5 5 5 5 5 5 4 4 4 4 4 4 5
0 0 0 0 0 0 1 1 1 1 1 1 1 1 1 3 0 0 0 2 2 A C C C C C D C C C C C C C C C C C C C B C C C C C C C D C C C C C C A A A A A 4 4 4 4 5 5 5 5 5 5 5 5 5 5 5 5 5 5 7 5 5 5 4 4 4 4 5 4 4
0 0 0 0 2 2 1 1 1 2 0 0 0 3 0 0 0 0 0 2 2 A C C E C D C C C B C C C C C C C C C C C C C C C C C D C C C C C C C A A A A A 4 4 5 4 4 5 5 5 5 5 5 5 5 5 5 5 5 5 5 5 5 5 4 4 5 4 4 4 4
0 0 0 0 0 0 1 1 1 1 1 1 1 1 1 0 0 0 0 2 2 A C C C D C C C C C C C C C C C C E C C C C C C C C D C C C C C C C C C A A A A A 4 4 4 4 5 5 5 5 5 5 5 5 5 5 7 5 5 5 5 5 5 5 4 4 4 4 4 4
0 0 0 0 0 2 1 1 1 2 0 2 0 0 0 0 0 0 0 2 2 A C C D C C C C C C C C C C C C C C C C C C C C C D C C C C C E C C C C A A A A A 4 4 4 5 5 5 5 5 5 5 5 5 5 5 5 5 5 5 5 5 5 5 4 4 4 4 4 4
0 0 0 2 0 0 1 1 1 0 1 0 0 0 0 0 0 0 0 2 2 A C D C C C C C C C C C C C C C C C C C C C C C D C C C C B C C C C C C A A A A A 4 4 4 4 5 5 5 5 5 5 5 7 5 5 5 5 5 5 5 5 5 4 4 4 4 4 4 4
0 0 0 0 0 3 2 0 0 0 2 0 0 0 0 0 0 0 2 2 2 A D C C C C C C C C C C E C C C C C B C C C C D C C C C C C C C C C C C A A A A A 4 4 4 4 5 5 5 5 5 5 5 5 5 5 5 5 5 5 5 5 5 4 4 4 4 4 5 4
0 0 0 3 0 0 0 0 1 1 1 0 0 0 0 0 0 0 0 2 2 A C C C C C C B C C C C C C C C C C C C C C D C C C E C C C C C C C C C C A A A A A 4 5 4 5 5 5 5 7 5 5 5 5 5 5 5 5 5 5 5 5 4 4 4 5 4 4 4
0 3 2 0 0 0 0 2 1 1 1 2 0 0 0 0 0 0 0 2 3 A C C C C C C C C C C C C C C C C C C C C D C C C C C C C C C C C C C C C A A A A A 4 4 4 5 5 5 5 5 5 5 5 5 5 5 5 5 5 8 8 8 8 9 8 8 8 8 4
0 0 0 0 0 0 0 0 0 0 0 0 0 0 0 0 0 2 3 2 2 A C C C C C C E C C C C C C C C C C C C D C C C C C C C C C C C C C C C C A A A A A 4 4 4 4 7 5 5 5 5 5 5 5 5 5 5 8 8 9 9 9 9 9 9 9 9 9 8
0 0 0 0 0 0 0 0 0 2 1 1 1 2 0 0 3 0 0 2 2 A C C C C C C C C C C C C C C C C C C D C E C C C C C B C C C C C C C C C A A A A A 4 4 4 4 4 5 5 5 5 5 5 5 5 5 8 9 9 9 9 9 9 9 9 9 9 9 9
0 2 0 0 0 0 0 0 0 0 1 1 1 0 3 0 0 0 0 2 2 A C C C C C C C C C C C C C C C B C D C C C C C C C C C C C C C C C C E C A A A A A 4 7 4 4 5 4 5 5 5 5 5 5 5 5 8 9 9 9 9 9 9 9 9 9 9 9 9
0 0 0 0 0 0 0 0 0 0 2 0 3 0 2 0 2 0 0 2 2 A C E C C B C C C C C C C C C C C D C C C C C C C C C C C C C C C C C C C C A A A A A 4 5 4 4 4 4 5 5 5 5 5 5 8 9 9 9 9 9 9 9 9 9 9 9 9 9
0 0 0 0 0 0 0 0 2 0 3 0 1 1 1 0 0 0 0 2 2 A C C C C C C C C C C C C C C C D C C C C C C C C C C C C C C C C C C C C C A A A A A 4 4 4 4 4 4 4 4 4 4 5 4 4 8 9 9 9 9 9 9 9 9 9 9 9 9
2 0 0 0 0 0 0 0 3 0 0 2 1 1 1 2 0 0 0 2 2 A C C C C C C C C C C C C C C D C C C C C C C C C C C C C C E C C C C C B D A A A A A 4 4 4 4 4 4 4 4 5 4 4 4 4 8 9 9 9 9 9 9 9 9 9 9 9 9
0 0 0 0 0 0 3 0 0 0 0 0 0 0 0 2 0 0 0 2 2 A C C C C C C C C C C C C C D C C C C C C C C C C B C C C C C C C C C C D C A A A A A 4 4 4 4 4 4 5 4 4 4 4 4 4 4 8 8 9 9 9 9 9 9 9 9 9 8
0 0 0 0 3 0 0 2 0 0 0 0 2 1 1 1 2 0 0 2 2 A C C C C C C C C C C E C D B C C C C C C C C C C C C C C C C C C C C D C C A A A A A 4 4 4 4 5 4 4 4 4 4 4 7 4 4 4 5 8 8 8 8 9 8 8 8 8 4
0 0 3 0 0 0 0 0 0 0 0 0 0 0 1 1 1 0 0 0 2 3 A C B C C C C C C C C D C C C C C C C C C C C C E C C C C C C C C D C C C A A A A A 4 4 5 4 4 4 4 4 4 4 4 4 4 5 4 4 4 4 4 4 4 4 4 4 5 4
3 0 0 0 0 0 0 0 0 0 0 0 0 2 2 0 0 2 0 3 2 2 A C C C C C C C C C D C C C C C C C C C C C C C C C C C C C C C D C C C C A A A A A 5 4 4 4 4 4 4 4 7 4 4 5 4 4 4 4 4 4 4 4 4 4 5 4 4 4
0 0 0 0 0 0 2 0 0 0 0 0 0 0 1 1 1 3 0 0 2 2 A C C C C E C C C D C C C C C C C C C C C C C C C C C C C C C D C B C C C A A A A A 4 4 4 4 4 4 4 4 4 5 4 4 4 4 4 4 4 4 4 4 5 4 4 4 4 7
0 0 0 0 0 0 0 0 0 0 0 0 0 2 1 1 1 2 0 0 2 2 A C C C C C C C D C C C C C C C C C C E C C B C C C C C C C D C C C C C C A A A A A 4 4 4 4 4 7 4 5 4 4 4 4 4 4 4 4 4 4 5 4 4 4 4 4 4 4
0 0 0 0 0 0 0 0 0 0 0 0 0 3 0 0 0 0 0 0 0 2 2 A C C C C C D C C C B C C C C C C C C C C C C C C C C C D C C C E C C C A A A A A 4 4 4 4 4 5 4 4 4 4 4 4 4 4 4 4 5 4 4 4 4 4 7 4 4 4
0 0 0 0 0 2 0 0 0 0 0 3 0 2 1 1 1 2 0 0 0 2 2 A C C C C D C C C C C C C C C C C C C C C C C C C C C D C C C C C C C C A A A A A 4 4 7 5 4 4 4 4 4 4 4 4 4 4 5 4 4 4 4 4 4 4 4 4 4 5
0 0 0 0 0 0 0 0 0 3 0 0 0 1 1 1 0 0 0 0 2 2 2 A C C C D C C C C C C C C E C C C C C C C C C C C C D C C C C C C C C C A A A A A 4 5 4 4 4 4 4 4 4 4 4 4 5 4 4 4 4 4 4 7 4 4 4 5 4 4
0 0 0 0 0 0 0 3 0 0 0 0 2 0 0 0 2 0 0 0 0 2 2 A C C D C C C C C C C C C C C C C C C C C C C C C D C E C C B C C C C C A A A A A 4 4 4 4 4 4 4 4 4 4 5 4 4 4 4 4 4 4 4 4 4 5 4 4 4 4
0 0 0 0 2 3 0 0 0 0 0 0 0 1 1 1 0 0 0 0 0 0 2 2 A D C C C C C C C C C C C C C C C C B C C C C D C C C C C C C C C C C A A A A A 4 4 4 4 4 4 4 4 5 4 4 4 4 4 4 4 7 4 4 5 4 4 4 4 4 4
0 0 0 3 0 0 0 0 0 0 0 2 1 1 1 2 0 0 0 2 0 0 3 2 A C C C C C C E C C C C C C C C C C C C C C D C C C C C C C C C C C C A A A A A 4 4 4 4 4 4 5 4 4 4 4 4 4 4 4 4 4 5 4 4 4 4 4 4 4 4
0 3 0 0 0 0 0 0 0 0 0 2 0 0 0 0 0 0 0 0 3 0 2 2 A C C C C C C C C C C C C C C C C C C C C D C C C C C C C C C C C C C A A A A A 4 4 4 4 5 4 4 4 4 4 4 4 4 7 4 5 4 4 4 4 4 4 4 4 4 4
0 0 0 2 0 0 0 0 0 0 2 1 1 1 2 0 0 0 3 0 0 0 0 2 2 A C C C C C C C C C C C C C C C C C C D C C C C C C C C C C C C C C A A A A A 4 4 5 4 4 4 4 4 4 4 4 4 4 5 4 4 4 4 4 4 4 4 4 4 5 4
0 0 0 0 0 0 0 0 0 0 1 1 1 0 0 0 3 0 2 0 0 0 0 2 2 A E C C C C C C C C C C C C C C C C D C C C C C C C B C C C C C C C A A A A A 5 4 4 4 4 4 4 4 4 4 7 5 4 4 4 4 4 4 4 4 4 4 5 4 4 4
R 8 14 1 4
R 16 32 1 5
R 20 58 1 4
R 12 70 1 5
R 22 40 1 4
R 33 18 2 4
R 42 30 2 5
R 48 48 2 4
R 36 66 2 5
R 52 24 2 4
R 68 16 3 4
R 74 36 3 5
R 80 54 3 4
R 86 68 3 5
R 70 82 3 4
