50 50
0 0 0 0 0 0 0 0 0 0 3 3 0 0 0 0 0 0 0 0 0 0 0 0 0 0 6 6 8 8 5 5 5 5 8 3 3 8 8 8 8 8 8 8 8 8 8 8 8 8
0 0 0 0 0 0 0 0 0 0 3 3 0 0 0 0 0 0 0 0 0 0 0 0 0 0 6 6 8 8 8 8 8 8 8 3 3 8 8 8 8 8 8 8 8 8 8 8 8 8
0 0 5 0 0 0 0 0 0 0 3 3 0 0 0 0 0 0 0 0 0 0 0 0 0 0 6 6 8 8 8 8 8 8 8 3 3 8 8 8 8 8 8 8 8 8 8 8 8 8
0 0 0 0 0 0 0 0 0 0 3 3 0 0 0 0 A A 0 0 0 0 0 0 0 0 6 6 8 8 5 5 5 5 8 3 3 8 8 8 5 8 8 8 8 8 8 8 8 8
0 0 0 0 6 6 6 6 6 6 3 3 0 0 0 0 A A 0 0 5 0 0 0 0 0 6 6 8 8 8 8 8 8 8 3 3 8 8 8 8 8 8 8 5 8 8 8 8 8
0 0 0 0 6 4 4 4 4 4 3 3 0 0 0 0 3 3 0 0 0 0 0 0 0 0 6 6 8 8 8 8 8 8 8 3 3 8 8 8 8 8 8 8 8 8 8 8 8 8
0 0 0 0 6 4 4 4 4 4 3 3 0 0 5 0 0 0 0 0 0 0 0 0 0 0 6 6 8 8 5 5 5 5 9 9 9 9 9 9 8 8 8 8 8 8 5 8 8 8
0 0 0 0 6 4 4 4 4 4 3 3 0 0 0 0 0 0 0 0 0 0 0 0 0 0 6 6 8 8 8 8 8 8 9 9 9 9 9 9 8 8 8 8 8 8 8 8 8 8
0 0 0 5 6 4 4 4 4 4 3 3 0 0 0 0 0 0 0 0 0 0 0 0 0 0 6 6 8 8 8 8 8 8 9 9 9 9 9 9 8 8 A A 8 8 8 8 8 8
0 0 0 0 6 4 4 4 4 4 3 3 0 0 0 0 0 0 0 0 0 0 0 0 0 0 6 6 8 8 5 5 5 5 9 9 3 3 3 3 3 3 A A 8 8 8 8 8 8
0 0 0 0 6 6 6 6 6 6 3 3 0 0 0 0 0 0 5 0 0 0 0 0 0 0 6 6 8 8 8 8 8 8 9 9 9 9 9 9 8 8 8 8 8 8 8 8 8 8
0 0 0 0 0 0 0 0 0 0 3 3 0 0 0 0 0 0 0 0 0 0 0 0 0 0 6 6 8 8 8 8 8 8 9 9 9 9 9 9 8 8 8 8 8 8 8 8 8 8
0 0 0 0 0 0 0 0 0 0 3 3 0 0 0 0 0 0 0 0 0 0 0 5 0 0 6 6 8 8 5 5 5 5 9 3 3 9 5 9 8 8 8 8 8 8 8 8 8 8
0 0 0 0 0 0 0 0 0 0 3 3 0 0 0 0 0 0 0 0 0 0 0 0 0 0 6 6 8 8 8 8 8 8 9 3 3 9 9 9 8 8 8 8 8 8 8 8 8 8
0 0 0 0 0 0 0 5 0 0 3 3 0 0 0 0 0 0 0 0 0 0 3 3 3 3 3 6 8 8 8 8 8 8 9 3 3 9 9 9 8 8 8 8 8 8 8 8 8 8
0 0 0 0 0 0 0 0 0 0 3 3 0 0 0 0 0 0 0 0 0 0 3 5 0 5 3 6 8 8 5 5 5 5 9 3 3 9 9 9 8 8 8 8 8 8 8 8 8 8
0 0 0 0 0 0 0 0 0 0 3 3 0 0 0 0 0 0 0 0 0 0 3 0 0 0 3 6 8 8 8 8 8 8 8 3 3 8 8 8 8 8 8 8 8 8 8 8 8 8
0 0 0 0 0 0 0 0 0 0 3 3 0 0 0 0 0 0 0 0 0 0 3 5 0 5 3 6 8 8 8 8 8 8 8 3 3 8 8 8 8 8 8 8 8 8 8 8 8 8
0 0 0 0 0 0 0 0 0 0 3 3 0 0 0 5 0 0 0 0 0 0 3 3 3 3 3 6 8 8 5 5 5 5 8 3 3 8 8 8 8 8 8 8 8 8 8 8 8 8
0 0 0 0 0 0 0 0 0 0 3 3 0 0 0 0 0 0 0 0 0 0 0 0 3 3 6 6 8 8 8 8 8 8 8 3 3 8 8 8 8 8 8 8 8 8 8 8 8 8
0 0 0 0 0 0 0 0 0 0 3 3 0 0 0 0 0 0 0 0 0 0 0 0 3 3 6 6 8 8 8 8 8 8 8 3 3 8 8 8 8 8 8 8 8 8 8 8 8 8
0 0 0 0 0 0 0 0 0 0 3 3 0 0 0 0 0 0 0 0 0 0 0 0 3 3 6 6 8 8 5 5 5 5 8 3 3 8 8 8 8 8 8 8 8 8 8 8 8 8
0 0 0 0 0 0 0 0 0 0 3 3 0 0 0 0 0 0 0 0 0 0 0 0 3 3 6 6 8 8 8 8 8 8 8 3 3 8 8 8 8 8 8 8 8 8 8 8 8 8
0 0 0 0 0 0 0 0 0 0 3 3 0 0 0 0 0 0 0 0 0 0 0 0 3 3 6 6 8 8 8 8 8 8 8 3 3 8 8 8 8 8 8 8 8 8 8 8 8 8
3 3 3 3 3 3 3 3 3 3 3 3 3 3 3 3 3 3 3 3 3 3 3 3 3 3 3 3 3 3 3 3 3 3 3 3 3 3 3 3 3 3 3 3 3 3 3 3 3 3
3 3 3 3 3 3 3 3 3 3 3 3 3 3 3 3 3 3 3 3 3 3 3 3 3 3 3 3 3 3 3 3 3 3 3 3 3 3 3 3 3 3 3 3 3 3 3 3 3 3
0 0 0 0 0 0 0 0 0 0 3 3 0 0 0 0 0 0 0 0 0 0 0 0 0 0 0 0 0 0 0 0 0 3 3 3 3 0 0 0 0 0 0 0 0 0 0 0 0 0
0 0 0 0 0 0 0 0 0 0 3 3 0 0 0 0 0 0 0 0 0 0 0 0 0 0 0 0 0 0 0 0 0 3 3 3 3 0 0 0 0 0 0 0 0 0 0 0 0 0
D D D D D D D D D D 3 3 D D D D D D D D D D D D D D 6 6 8 8 8 8 8 3 3 3 3 8 8 8 8 8 8 8 8 8 8 8 8 8
D D D D D D D D D D 3 3 D D D D D D D D D D D D D D 6 6 6 6 6 6 6 3 3 3 3 6 6 6 6 6 6 6 6 6 6 6 6 6
D D D D D D D D D D 3 3 D D D D D D D D D D D D D D 6 6 6 6 6 6 6 3 3 3 3 6 6 6 6 6 6 6 6 6 6 6 6 6
D D D D D D D D D D 3 3 D D D D D D E E E E E D D D 6 6 D D D E E 3 3 3 3 D D D D D D D D D D D D D
E E E E E E D D D D 3 3 D D D D D D E E E E E D D D 6 6 D D D E A A A A 3 D D D D D D D D D D D D D
E E E E E E E D D D 3 3 D D D D D D E E E E E D D D 6 6 D D D E A 3 3 A 3 D D D D D D D D D D D D D
D D D E A A F 3 3 3 3 3 D D D D D D E E E E E D D D 6 6 D D D E A 3 3 A 3 D D D D D D D D D D D D D
D D D E A A F 3 3 3 3 3 D D D D D D E E E E E D D D 6 6 D D D E A A A A 3 D D D D D D D D D D D D D
D D D E E E E D D D 3 3 D D D D D D D D D D D D D D 6 6 D D D E E E E 3 3 D D D D D D D D D D D D D
D D D E E E E D D D 3 3 D D D D D D D D D D D D D D 6 6 D D D D D D D 3 3 D D D D D D D D D D D D D
3 3 3 3 3 3 3 3 3 3 3 3 3 3 3 3 3 3 3 3 3 3 3 3 3 3 3 3 3 3 3 3 3 3 3 3 3 3 3 3 3 3 3 3 3 3 3 3 3 3
3 3 3 3 3 3 3 3 3 3 3 3 3 3 3 3 3 3 3 3 3 3 3 3 3 3 3 3 3 3 3 3 3 3 3 3 3 3 3 3 3 3 3 3 3 3 3 3 3 3
D D D D D D D D D D 3 3 D D D D D D 5 D D D D D D D D D D D D D E D D 3 3 D D D E D D D E D D D D D
D D D D D D E E E E F F D D D D D D D D D D D D D D D D D D D E D D D 3 3 D D E D D D E D D D D D D
D D D D D D E E E E F F 5 D D D D D D D D D D D D D D D D D E D D D E 3 3 D E D D D E D D D D D D D
D D D D D D E E E E F F D D D D D D D D D D D D D D D D D D D D D E D 3 3 E D D D E D D D E D D D D
D D D D D D E E E E F F D D 5 D D D D D D D D D D D D D D D D D E D D 3 3 D D D E D D D E D D D D D
D D D D D D E E E E F F D D D D D D D D D D D D D D D D D D D E E E E 3 3 E E E D D D E D D D D D D
D D D D D D D D D D 3 3 D D D D 5 D D D E E E E E E E E D D E D F F F 3 3 F E E D D E D D D D D D D
D D D D D D D D D D 3 3 D D D D D D D D E E E E E E E E D D D D F F F 3 3 F E E D E D D D E D D D D
D D D D D D D D D D 3 3 D D D D D D D D E E E E E E E E D D D D D D D 3 3 D D D D D D D D D D D D D
D D D D D D D D D D 3 3 D D D D D D D D D D D D D D D D D D D D D D D 3 3 D D D D D D D D D D D D D
