100 100
5 5 5 5 5 5 5 5 5 5 5 5 5 5 5 5 5 5 5 5 5 5 5 5 5 5 5 5 5 5 3 3 5 5 5 5 5 5 5 5 5 5 5 5 5 5 5 5 5 5 5 5 5 5 5 5 5 5 5 5 5 5 5 5 5 5 5 5 5 5 5 5 5 5 5 5 5 5 5 5 5 5 5 5 5 5 5 5 5 5 5 5 5 5 5 5 5 5 5 5
5 5 5 5 5 5 5 5 5 5 5 5 5 5 5 5 5 5 5 5 5 5 5 5 5 5 5 5 5 5 3 3 5 5 5 5 5 5 5 5 5 5 5 5 5 5 5 5 5 5 5 5 5 5 5 5 5 5 5 5 5 5 5 5 5 5 5 5 5 5 5 5 5 5 5 5 5 5 5 5 5 5 5 5 5 5 5 5 5 5 5 5 5 5 5 5 5 5 5 5
5 5 5 0 0 0 0 0 0 0 0 0 0 0 0 0 0 0 0 0 0 0 0 0 0 0 0 0 0 0 3 3 0 0 0 0 0 0 0 0 0 0 0 0 0 0 0 0 0 0 0 0 0 0 0 0 0 0 0 0 0 0 0 0 0 0 0 0 0 0 0 0 0 0 0 0 0 0 0 0 0 0 0 0 0 0 0 0 0 0 0 0 0 0 0 0 0 5 5 5
5 5 5 0 0 0 0 0 0 0 0 0 0 0 0 0 0 0 0 0 0 0 0 0 0 0 0 0 0 0 3 3 0 0 0 0 0 0 0 0 0 0 0 0 0 0 0 0 0 0 0 0 0 0 0 0 0 0 0 0 0 0 0 0 0 0 0 0 0 0 0 0 0 0 0 0 0 0 0 0 0 0 0 0 0 0 0 0 0 0 0 0 0 0 0 0 0 5 5 5
5 5 5 0 0 0 0 0 6 6 6 0 0 0 0 0 0 0 0 0 0 0 0 0 0 0 0 0 0 0 3 3 6 0 0 0 0 0 0 0 0 0 0 0 0 0 0 0 0 0 0 0 5 0 0 0 0 0 0 0 0 0 0 0 0 0 0 0 0 0 0 0 0 0 0 0 0 0 0 0 0 0 0 0 0 0 0 0 0 0 0 0 0 0 0 0 0 5 5 5
5 5 5 0 0 0 0 0 6 6 6 0 0 0 0 0 0 0 5 0 0 0 0 0 0 0 0 0 0 0 3 3 6 0 0 0 0 0 0 0 0 0 0 0 0 0 0 0 0 0 0 5 5 5 0 0 0 0 0 6 6 6 0 0 0 0 0 0 0 0 0 0 0 0 0 0 0 0 0 0 0 0 0 0 0 0 0 0 0 0 0 0 0 0 0 0 0 5 5 5
5 5 5 0 0 0 0 0 6 6 6 0 3 3 3 3 3 3 3 3 3 3 3 3 3 3 3 3 0 0 3 3 6 0 0 0 0 0 0 0 0 0 0 0 5 0 0 0 0 0 5 5 5 6 6 6 6 6 6 6 4 6 6 6 6 6 6 6 0 0 0 0 0 0 0 0 0 0 0 0 0 0 0 0 0 0 0 0 0 0 0 0 0 0 0 0 0 5 5 5
5 5 5 0 0 0 0 0 6 6 6 0 0 0 0 0 5 5 5 5 5 0 0 0 0 0 0 0 0 0 3 3 6 0 0 0 0 0 0 0 0 0 5 5 5 5 5 0 0 0 0 6 6 6 4 4 4 4 4 4 4 4 4 4 4 3 4 6 6 6 0 0 0 0 0 0 0 0 0 0 0 0 0 0 0 0 0 0 0 0 0 0 0 0 0 0 0 5 5 5
5 5 5 0 0 0 0 0 6 6 6 0 3 3 3 3 3 3 3 3 3 3 3 3 3 3 3 3 0 0 3 3 6 0 0 0 0 0 0 0 0 5 5 5 5 5 5 5 0 6 6 6 4 4 4 4 4 4 4 4 4 4 4 4 4 3 4 4 4 6 6 6 0 0 0 0 0 0 0 0 0 0 0 0 0 0 0 0 0 0 0 0 0 0 0 0 0 5 5 5
5 5 5 0 0 0 0 0 6 6 6 0 0 0 0 0 5 5 5 5 5 0 0 0 0 0 0 0 0 0 3 3 6 0 0 0 0 0 0 0 0 5 5 5 5 5 5 5 6 6 4 4 4 4 4 4 4 4 4 4 4 4 4 4 4 3 4 4 4 4 4 6 6 0 0 0 0 0 0 0 0 0 0 0 0 0 0 0 0 0 0 0 0 0 0 0 0 5 5 5
5 5 5 0 0 0 0 0 6 6 6 0 3 3 3 3 3 3 3 3 3 3 3 3 3 3 3 3 0 0 3 3 6 0 0 0 0 0 0 0 5 5 5 5 5 5 5 5 6 4 4 4 4 4 4 4 4 4 4 4 4 4 4 4 4 3 4 4 4 4 4 4 6 0 0 0 0 0 0 0 0 0 0 0 0 0 0 0 0 0 0 0 0 0 0 0 0 5 5 5
5 5 5 0 0 0 0 0 6 6 6 0 0 0 0 0 0 0 5 0 0 0 0 0 0 0 0 0 0 0 3 3 6 0 0 0 0 0 0 0 0 5 5 5 5 5 5 6 6 4 4 4 4 4 4 4 4 4 4 4 4 4 4 4 4 3 4 4 4 4 4 4 6 6 0 0 0 0 0 0 0 0 0 0 0 0 0 0 0 0 0 0 0 0 0 0 0 5 5 5
5 5 5 0 0 0 0 0 6 6 6 0 0 0 0 0 0 0 0 0 0 0 0 0 0 0 0 0 0 0 3 3 6 0 0 0 0 0 0 0 0 5 5 5 5 5 5 6 4 4 4 4 4 4 4 4 4 4 4 4 4 4 4 4 4 3 4 4 4 4 4 4 4 6 0 0 0 0 0 0 0 0 0 0 0 0 0 0 0 0 0 0 0 0 0 0 0 5 5 5
5 5 5 0 0 0 0 0 6 6 6 0 0 0 0 0 0 0 0 0 0 0 0 0 0 0 0 0 0 0 3 3 6 0 0 0 0 0 0 0 0 0 5 5 5 5 5 6 6 4 4 4 4 4 4 4 4 4 4 4 4 4 4 4 4 3 4 4 4 4 4 4 6 6 0 0 0 0 0 0 0 0 0 0 0 0 0 0 0 0 0 0 0 0 0 0 0 5 5 5
5 5 5 0 0 0 0 0 6 6 6 0 0 0 0 0 0 0 0 0 0 0 0 0 0 0 0 0 0 0 3 3 6 0 0 0 0 0 0 0 0 0 0 0 5 0 0 0 6 4 4 4 4 4 4 4 4 4 4 4 4 4 4 4 4 3 4 4 4 4 4 4 6 5 0 0 0 0 0 0 0 0 0 0 0 0 0 0 0 0 0 0 0 0 0 0 0 5 5 5
5 5 5 0 0 0 0 0 6 6 6 0 0 0 0 0 0 0 0 0 0 0 0 0 0 0 0 0 0 0 3 3 6 0 0 0 0 0 0 0 0 0 0 0 0 0 0 0 6 6 4 4 4 4 4 4 4 4 4 4 4 4 4 4 4 3 4 4 4 4 4 6 6 5 5 0 0 0 0 0 0 0 0 0 0 0 0 0 0 0 0 0 0 0 0 0 0 5 5 5
5 5 5 0 0 0 0 0 6 6 6 0 0 0 0 0 0 0 0 0 0 0 0 0 0 0 0 0 0 0 3 3 6 0 0 0 0 0 0 0 0 0 0 0 0 0 0 0 0 6 6 6 4 4 4 4 4 4 4 4 4 4 4 4 4 3 4 4 4 6 6 6 5 5 5 0 0 0 0 0 0 0 0 0 0 0 0 0 0 0 0 0 0 0 0 0 0 5 5 5
5 5 5 0 0 0 0 0 0 0 0 0 0 0 0 0 0 0 0 0 0 0 0 0 0 0 0 0 0 0 3 3 0 0 0 0 0 0 0 0 0 0 0 0 0 0 0 0 0 0 0 6 6 6 4 4 4 4 4 4 4 4 4 4 4 3 4 6 6 6 5 5 5 5 5 0 0 0 0 0 0 0 0 0 0 0 0 0 0 0 0 0 0 0 0 0 0 5 5 5
5 5 5 0 0 0 0 0 0 0 0 0 0 0 0 0 0 0 0 0 A A A A A A 6 6 0 6 3 3 6 6 0 0 0 A A A A A A 0 0 0 0 0 0 0 0 0 0 6 6 6 6 6 6 6 4 6 6 6 6 6 6 6 5 5 5 5 5 5 5 5 0 0 0 0 0 0 0 0 0 0 0 0 0 0 0 0 0 0 0 0 0 5 5 5
5 5 5 0 0 0 0 0 0 0 0 0 0 0 0 0 0 0 0 0 A 3 3 3 3 A 6 6 0 6 3 3 6 6 0 0 0 A 3 3 3 3 A 0 0 0 0 0 0 0 0 0 0 5 5 5 5 5 0 6 6 6 0 0 0 0 5 5 5 5 5 5 5 5 5 0 0 0 0 0 0 0 0 0 0 0 0 0 0 0 0 0 0 0 0 0 0 5 5 5
5 5 5 0 0 0 0 0 0 0 0 0 0 0 0 0 5 0 0 0 A 3 3 3 3 A 3 3 3 3 3 3 3 3 3 3 3 A 3 3 3 3 A 0 0 0 0 0 0 0 0 0 5 5 5 5 5 5 5 0 0 0 0 0 0 0 5 5 5 5 5 5 5 5 5 0 0 0 0 0 0 0 0 0 0 0 0 0 0 0 0 0 0 0 0 0 0 5 5 5
5 5 5 0 0 0 0 0 0 0 0 0 0 0 0 5 5 5 0 0 A 3 3 3 3 A 3 3 3 3 3 3 3 3 3 3 3 A 3 3 3 3 A 0 0 0 0 0 0 0 0 0 0 5 5 5 5 5 0 0 0 0 0 0 0 0 5 5 5 5 5 5 5 5 5 0 0 0 0 0 0 0 0 0 0 0 0 0 0 0 0 0 0 0 0 0 0 5 5 5
5 5 5 0 0 0 0 0 0 0 0 0 0 0 5 5 5 5 5 0 A 3 3 3 3 A 3 3 3 3 3 3 3 3 3 3 3 A 3 3 3 3 A 0 0 0 0 0 0 0 0 0 0 5 5 5 5 5 0 0 0 0 0 0 0 0 0 5 5 5 5 5 5 5 0 0 0 0 0 0 0 0 0 0 0 0 0 0 0 0 0 0 0 0 0 0 0 5 5 5
5 5 5 0 0 0 0 0 0 0 0 0 0 0 0 5 5 5 0 0 A 3 3 3 3 A 3 3 3 3 3 3 3 3 3 3 3 A 3 3 3 3 A 0 5 0 0 0 0 0 0 0 0 0 0 5 0 0 0 0 0 0 0 0 0 0 0 0 0 0 5 0 0 0 0 0 0 0 0 0 0 0 0 0 0 0 0 0 0 0 0 0 0 0 0 0 0 5 5 5
3 3 3 3 3 3 3 3 3 3 3 3 3 3 3 3 3 3 3 3 3 3 3 3 3 3 3 3 3 3 3 3 3 3 3 3 3 3 3 3 3 3 3 3 3 3 3 3 3 3 3 3 3 3 3 3 3 3 3 3 3 3 3 3 3 3 3 3 3 3 3 3 3 3 3 3 3 3 3 3 3 3 3 3 3 3 3 3 3 3 3 3 3 3 3 3 3 3 3 3
5 5 5 0 0 0 0 0 0 0 0 0 0 0 0 0 0 0 0 0 A A A A A A 3 3 3 3 3 3 3 3 3 3 3 A A A A A 3 3 5 5 5 0 0 0 0 0 0 0 0 0 0 0 0 0 0 0 0 0 0 0 0 0 0 0 0 0 0 0 0 0 0 0 0 0 0 0 0 0 0 0 0 0 0 0 0 0 0 0 0 0 0 5 5 5
5 5 5 0 0 0 0 0 0 0 0 0 0 0 0 0 0 0 0 0 A 3 3 3 3 A 3 3 3 3 3 3 3 3 3 3 3 A 3 3 3 3 A 5 3 3 5 5 0 0 0 0 0 0 0 0 0 0 0 0 0 0 0 0 0 0 0 0 0 0 0 0 0 0 0 0 0 0 0 0 0 0 0 0 0 0 0 0 0 0 0 0 0 0 0 0 0 5 5 5
5 5 5 0 0 0 0 0 0 0 0 0 0 0 0 0 0 0 0 0 A 3 3 3 3 A 3 3 3 3 3 3 3 3 3 3 3 A 3 3 3 3 A 5 5 5 3 3 0 0 0 0 0 0 0 0 0 0 0 0 0 0 0 0 0 0 0 0 0 0 0 0 0 0 0 0 0 0 0 0 0 0 0 0 0 0 0 0 0 0 0 0 0 0 0 0 0 5 5 5
5 5 5 0 0 0 0 0 0 0 0 0 0 0 0 0 0 0 0 0 A 3 3 3 3 A 3 3 3 3 3 3 3 3 3 3 3 A 3 3 3 3 A 5 5 5 5 0 3 3 0 0 0 0 0 0 0 0 0 0 0 0 0 0 0 0 0 0 0 0 0 0 0 0 0 0 0 0 0 0 0 0 0 0 0 0 0 0 0 0 0 0 0 0 0 0 0 5 5 5
5 5 5 0 0 0 0 0 0 0 0 0 0 0 0 0 0 0 0 0 A 3 3 3 3 A 3 3 3 3 3 3 3 3 3 3 3 A 3 3 3 3 A 0 5 0 0 0 0 0 0 0 0 0 0 0 0 0 0 0 0 0 0 0 0 0 0 0 0 0 0 0 0 0 0 0 0 0 0 0 0 0 0 0 0 0 0 0 0 0 0 0 0 0 0 0 0 5 5 5
5 5 5 0 0 0 0 0 0 0 0 0 0 0 0 0 0 0 0 0 A 3 3 3 3 A 3 3 3 3 3 3 3 3 3 3 3 A 3 3 3 3 A 0 0 0 0 0 0 0 0 0 0 0 0 0 0 0 0 0 0 0 0 0 0 0 0 0 0 0 0 0 0 0 0 0 0 0 0 0 0 0 0 0 0 0 0 0 0 0 0 0 0 0 0 0 0 5 5 5
5 5 5 6 6 6 6 6 6 6 6 6 6 6 6 6 6 6 6 6 A A A A A A 3 3 3 3 3 3 3 3 3 3 3 A A A A A A 6 6 6 6 6 6 6 6 6 6 6 6 6 6 6 6 6 6 6 6 6 6 6 6 6 6 6 6 6 6 6 6 6 6 6 6 6 6 6 6 6 6 6 6 6 6 6 6 6 6 6 6 6 6 5 5 5
5 5 5 6 6 6 6 6 6 6 6 6 6 6 6 6 6 6 6 6 6 6 6 6 3 3 3 3 3 3 3 3 3 3 3 3 3 6 6 6 6 6 6 6 6 6 6 6 6 6 6 6 6 6 6 6 6 6 6 6 6 6 6 6 6 6 6 6 6 6 6 6 6 6 6 6 6 6 6 6 6 6 6 6 6 6 6 6 6 6 6 6 6 6 6 6 6 5 5 5
9 8 9 8 9 8 9 8 9 8 9 8 9 8 9 8 9 8 9 8 9 8 9 8 9 8 9 8 9 8 3 3 9 8 9 8 9 8 9 8 9 8 9 8 9 8 9 8 9 8 9 8 9 8 9 8 9 8 9 8 9 8 9 8 9 8 9 8 9 8 9 8 9 8 9 8 9 8 9 8 9 8 9 8 9 8 9 8 9 8 9 8 9 8 9 8 9 8 9 8
9 8 9 8 9 8 9 8 9 8 9 8 9 8 9 8 9 8 9 8 9 8 9 8 9 8 9 8 9 8 3 3 9 8 9 8 9 8 9 8 9 8 9 8 9 8 9 8 9 8 9 8 9 8 9 8 9 8 9 8 9 8 9 8 9 8 9 8 9 8 9 8 9 8 9 8 9 8 9 8 9 8 9 8 9 8 9 8 9 8 9 8 9 8 9 8 9 8 9 8
8 8 8 8 8 8 8 8 8 8 8 8 8 8 8 8 8 8 8 8 8 8 8 8 8 8 8 8 8 8 3 3 8 8 8 8 8 8 8 8 8 8 8 8 8 8 8 8 8 8 8 8 8 8 8 8 8 8 8 8 8 8 8 8 8 8 8 8 8 8 8 8 8 8 8 8 8 8 8 8 8 8 8 8 8 8 8 8 8 8 8 8 8 8 8 8 8 8 8 8
8 8 8 8 8 8 8 8 8 8 8 8 8 8 8 8 8 8 8 8 8 8 8 8 8 8 8 8 8 8 3 3 8 8 8 8 8 8 8 8 8 8 8 8 8 8 8 8 8 8 8 8 8 8 8 8 8 8 8 8 8 8 8 8 8 8 8 8 8 8 8 8 8 8 8 8 8 8 8 8 8 8 8 8 8 8 8 8 8 8 8 8 8 8 8 8 8 8 8 8
8 8 8 8 8 8 8 8 8 8 8 8 5 8 8 8 8 8 8 8 8 8 8 8 8 8 8 8 8 8 3 3 8 8 8 8 8 8 8 8 8 8 8 8 8 8 8 8 8 8 8 8 8 8 8 8 8 8 8 8 8 8 8 8 8 8 8 8 8 8 8 8 8 8 8 8 8 8 8 8 8 8 8 8 8 8 8 8 8 8 8 8 8 8 8 8 8 8 8 8
8 8 8 8 8 8 8 8 8 8 5 5 5 5 5 8 8 8 8 8 8 8 8 8 8 8 8 8 8 8 3 3 8 8 8 8 8 8 8 8 8 8 8 8 8 8 8 8 8 8 8 8 8 8 8 8 8 8 8 8 8 8 8 8 8 8 8 8 A A A A A 8 8 8 8 8 8 8 8 8 8 8 8 8 8 8 8 8 8 8 8 8 8 8 8 8 8 8
8 8 8 8 8 8 8 8 8 8 5 5 5 5 5 8 8 8 8 8 8 8 8 8 8 8 8 8 8 8 3 3 8 8 8 8 8 8 8 8 8 8 8 8 8 8 8 8 8 8 8 8 8 8 8 8 8 8 8 8 8 8 8 8 8 8 8 8 A 9 9 9 A 8 8 8 8 8 8 8 8 8 8 8 8 8 8 8 8 8 8 8 8 8 8 8 8 8 8 8
8 8 8 8 8 8 8 8 8 5 5 5 5 5 5 5 8 8 8 8 8 8 8 8 8 8 8 8 8 8 3 3 8 8 8 8 8 8 8 8 8 8 8 8 8 8 8 8 8 8 8 8 8 8 8 8 8 8 8 8 8 8 8 8 8 8 8 8 A 9 3 9 A 8 8 8 8 8 8 8 8 8 8 8 8 8 8 8 8 8 7 8 8 8 8 8 8 8 8 8
8 8 8 8 8 8 8 8 8 8 5 5 5 5 5 8 8 8 8 8 8 8 8 8 8 8 8 8 8 8 3 3 9 9 9 9 9 9 9 9 9 9 9 9 9 8 8 8 8 8 8 8 8 8 8 8 8 8 8 8 8 8 8 8 8 8 8 8 A 9 3 9 A 8 8 8 8 8 8 8 8 8 9 9 9 9 9 9 9 9 9 9 9 9 9 8 8 8 8 8
8 8 8 8 8 8 8 8 8 8 5 5 5 5 5 8 8 8 8 8 8 8 8 8 8 8 8 8 9 9 3 3 9 9 9 9 9 9 9 9 9 9 9 9 9 9 9 9 8 8 8 8 8 8 8 8 8 8 8 8 8 8 8 8 8 8 8 8 A A A A A 8 8 8 8 8 8 9 9 9 9 9 9 9 9 9 9 9 9 9 9 9 9 8 8 8 8 8
8 8 8 8 8 8 8 8 8 8 8 8 5 8 8 8 8 8 8 8 8 8 8 9 9 9 9 9 9 9 3 3 9 9 9 9 9 9 9 9 9 9 9 9 9 9 9 9 9 9 9 9 9 8 8 8 8 8 8 8 8 8 8 8 8 8 8 8 8 8 8 8 8 9 9 9 9 9 9 9 9 9 9 9 9 9 9 9 9 9 9 9 9 9 9 8 8 8 8 8
8 8 8 8 8 9 8 8 8 8 8 8 8 8 8 8 8 8 8 8 9 9 9 9 9 9 9 9 9 9 3 3 8 8 9 9 9 8 8 8 8 8 8 8 8 9 9 9 9 9 9 9 9 9 9 9 9 8 8 8 8 8 8 8 8 8 8 8 8 8 9 9 9 9 9 9 9 9 9 9 9 9 8 8 8 8 8 8 8 8 7 8 8 8 8 8 8 8 8 8
8 8 8 8 8 9 9 9 9 9 9 9 9 9 9 9 9 9 9 9 9 9 9 9 9 9 9 9 8 8 3 3 8 9 9 9 9 9 8 8 8 8 8 8 8 8 8 8 9 9 9 9 9 9 9 9 9 9 9 9 9 9 9 9 9 9 9 9 9 9 9 9 9 9 9 9 9 9 9 8 8 8 8 8 8 8 8 8 8 8 8 8 8 8 8 8 8 8 8 8
8 8 8 8 8 9 9 9 9 9 9 9 9 9 9 9 9 9 9 9 9 9 9 8 8 8 8 8 8 8 3 3 8 8 9 9 9 8 8 8 8 8 8 8 8 8 8 8 8 8 8 8 8 A A A A A 9 9 9 9 9 9 9 9 9 9 9 9 9 9 9 8 8 8 8 8 8 8 5 8 8 8 8 8 8 8 8 8 8 8 8 8 8 8 8 8 8 8
8 8 8 8 8 8 9 9 9 9 9 9 9 9 9 9 9 9 9 9 8 8 8 8 8 8 8 8 8 8 3 3 8 8 8 9 8 8 8 8 8 8 8 8 8 8 8 8 8 8 8 8 8 A 9 9 9 A 9 9 9 9 9 9 9 9 9 9 9 9 8 8 8 8 8 8 8 8 5 5 5 5 5 8 8 8 8 8 8 8 8 8 8 8 8 8 8 8 8 8
8 8 8 8 8 8 8 8 8 8 8 8 8 8 8 8 8 8 8 8 8 8 8 8 8 8 8 8 8 8 3 3 8 8 8 8 8 8 8 8 8 8 8 8 8 8 8 8 8 8 8 8 8 A 9 3 9 A 8 8 8 8 8 8 8 8 8 8 8 8 8 8 8 8 8 8 8 5 5 5 5 5 5 5 8 8 8 8 8 8 8 8 8 8 8 8 8 8 8 8
8 8 8 8 8 8 8 8 8 8 8 8 8 8 8 8 8 8 8 8 8 8 8 8 8 8 8 8 8 8 3 3 8 8 8 8 8 8 8 8 8 8 8 8 8 8 8 8 8 8 8 8 8 A 9 3 9 A 8 8 8 8 8 8 8 8 8 8 8 8 8 8 8 8 8 8 8 5 5 5 5 5 5 5 8 8 8 8 8 8 8 8 8 8 8 8 8 8 8 8
8 8 8 8 8 8 8 8 8 8 8 8 8 8 8 8 8 8 8 8 8 8 8 8 8 8 8 8 8 8 3 3 8 8 8 8 8 8 8 8 8 8 8 8 8 8 8 8 8 8 8 8 8 A A A A A 8 8 7 8 8 8 8 8 8 8 8 8 8 8 8 8 8 8 5 5 5 5 5 5 5 5 5 8 8 8 8 8 8 8 8 8 8 8 8 8 8 8
8 8 8 8 8 8 8 8 8 8 8 8 8 8 8 8 8 8 8 8 5 8 8 8 8 8 8 8 8 8 3 3 8 8 8 8 8 8 8 8 8 8 8 8 8 8 8 8 8 8 8 8 8 8 8 8 8 8 8 7 7 7 8 8 8 8 8 8 8 8 8 8 8 8 8 8 8 5 5 5 5 5 5 5 8 8 8 8 8 8 8 8 8 8 8 8 8 8 8 8
8 8 8 8 8 8 8 8 8 8 8 8 8 8 8 8 8 8 5 5 5 5 5 8 8 8 8 8 8 8 3 3 8 8 8 8 8 8 8 8 8 8 8 8 8 8 8 8 8 8 8 8 8 8 8 8 8 8 7 7 7 7 7 8 8 8 8 8 8 8 8 8 8 8 8 8 8 5 5 5 5 5 5 5 8 8 8 8 8 8 8 8 8 8 8 8 8 8 8 8
8 8 8 8 8 8 8 8 8 8 8 8 8 8 8 8 8 5 5 5 5 5 5 5 8 8 8 8 8 8 3 3 8 8 8 8 8 8 8 8 8 8 8 8 8 8 8 8 8 8 8 8 8 8 8 8 8 8 8 7 7 7 8 8 8 8 8 8 8 8 8 8 8 8 8 8 8 8 5 5 5 5 5 8 8 8 8 8 8 8 8 8 8 8 8 8 8 8 8 8
8 8 8 8 8 8 8 8 8 8 8 8 8 8 8 8 8 5 5 5 5 5 5 5 8 8 8 8 8 8 3 3 8 8 8 8 8 8 8 8 8 8 8 8 8 8 8 8 8 8 8 8 8 8 8 8 8 8 8 8 7 8 8 8 8 8 8 8 8 8 8 8 8 8 8 8 8 8 8 8 5 8 8 8 8 8 8 8 8 8 8 8 8 8 8 8 8 8 8 8
8 8 8 8 8 8 8 8 8 8 8 8 8 8 8 8 5 5 5 5 5 5 5 5 5 9 8 8 8 8 3 3 8 8 8 8 8 8 8 8 8 8 8 8 8 8 8 8 8 8 8 8 8 8 8 8 8 8 8 8 8 8 8 8 8 8 8 8 8 8 8 8 7 8 8 8 8 8 8 8 8 8 8 8 8 8 8 8 8 8 8 8 8 8 8 8 8 8 8 8
8 8 8 8 8 8 8 8 8 8 8 8 8 8 8 8 8 5 5 5 5 5 5 9 9 9 9 9 8 8 3 3 8 8 8 8 8 8 8 8 8 8 8 8 8 8 8 8 8 8 8 8 8 8 8 8 8 8 8 8 8 8 8 8 8 8 8 8 8 8 7 7 7 7 7 8 8 8 8 8 8 8 8 8 8 8 8 8 8 8 8 8 8 8 8 8 8 8 8 8
8 8 8 8 8 8 8 8 8 8 8 8 8 8 8 8 8 5 5 5 5 5 5 9 9 9 9 9 8 8 3 3 8 8 8 8 8 8 8 8 8 8 8 8 8 5 8 8 8 8 8 8 8 8 8 8 8 8 8 8 8 8 8 8 8 8 8 8 8 8 7 7 7 7 7 8 8 8 8 8 8 8 8 8 8 8 8 8 8 8 8 8 8 8 8 8 8 8 8 8
8 8 8 8 8 8 8 8 8 8 8 8 8 8 8 8 8 8 5 5 5 5 9 9 9 9 9 9 9 8 3 3 8 8 8 8 8 8 8 8 8 8 8 5 5 5 5 5 A A A A A 8 8 8 8 8 8 8 8 8 8 8 8 8 8 8 8 7 7 7 7 7 7 7 8 8 8 8 8 8 8 8 8 8 8 8 8 8 8 8 8 8 8 8 8 8 8 8
8 8 8 8 8 8 8 8 8 8 8 8 8 8 8 8 8 8 8 8 5 8 8 9 9 9 9 9 8 8 3 3 8 8 8 8 8 8 8 8 8 8 8 5 5 5 5 5 A 9 9 9 A 8 8 8 8 8 8 8 8 8 8 8 8 8 8 8 8 8 7 7 7 7 7 8 8 8 8 8 8 8 8 8 8 8 8 8 8 8 8 8 8 8 8 8 8 8 8 8
8 8 8 8 8 8 8 8 8 8 8 8 8 8 8 8 8 8 8 8 8 8 8 9 9 9 9 9 8 8 3 3 8 8 8 8 8 8 8 8 8 8 5 5 5 5 5 5 A 9 3 9 A 8 8 8 8 8 8 8 8 8 8 8 8 8 8 8 8 8 7 7 7 7 7 8 8 8 8 8 8 8 8 8 8 8 8 8 8 8 8 8 8 8 8 8 8 8 8 8
8 8 8 8 8 8 8 8 8 8 8 8 8 8 8 8 8 8 8 8 8 8 8 8 8 9 8 8 8 8 3 3 8 8 8 8 8 8 8 8 8 8 8 5 5 5 5 5 A 9 3 9 A 8 8 8 8 8 8 8 8 8 8 8 8 8 8 8 8 8 8 8 7 8 8 8 8 8 8 8 8 8 8 8 8 8 8 8 8 8 8 8 8 8 8 8 8 8 8 8
8 8 8 8 8 8 8 8 8 8 8 8 8 8 8 8 8 8 8 8 8 8 8 8 8 8 8 8 8 8 3 3 8 8 8 8 8 8 8 8 8 8 8 5 5 5 5 5 A A A A A 8 8 8 8 8 8 8 8 8 8 8 8 8 8 8 8 8 8 8 8 8 8 8 8 8 8 8 8 8 7 7 7 7 7 7 7 8 8 8 8 8 8 8 8 8 8 8
8 8 8 8 8 8 8 8 8 8 8 8 8 8 8 8 8 8 8 8 8 8 8 8 8 8 8 8 8 8 3 3 8 8 8 8 8 8 8 8 8 8 8 8 8 5 8 8 8 8 8 8 8 8 8 8 8 8 8 8 8 8 8 8 8 8 8 8 8 8 8 8 8 8 8 8 8 8 8 8 8 8 7 3 3 3 3 3 7 8 8 8 8 8 8 8 8 8 8 8
7 8 8 7 8 8 7 8 8 7 8 8 7 8 8 7 8 8 7 8 8 7 8 8 7 8 8 7 8 8 3 3 8 7 8 8 7 8 8 7 8 8 7 8 8 7 8 8 7 8 8 7 8 8 7 8 8 7 8 8 7 8 8 7 8 8 7 8 8 7 8 8 7 8 8 7 8 8 7 8 8 7 7 3 3 3 3 3 7 8 7 8 8 7 8 8 7 8 8 7
7 8 8 7 8 8 7 8 8 7 8 8 7 8 8 7 8 8 7 8 8 7 8 8 7 8 8 7 8 8 3 3 8 7 8 8 7 8 8 7 8 8 7 8 8 7 8 8 7 8 8 7 8 8 7 8 8 7 8 8 7 8 8 7 8 8 7 8 8 7 8 8 7 8 8 7 8 8 7 8 8 7 7 7 7 7 7 7 7 8 7 8 8 7 8 8 7 8 8 7
E D E D E D E D E D E D E E E D E D E D E D E D E D E D E D 3 3 E D E D E D E D E D E D E D E D E E E D E D E D E D E D E D E D E D E D E D E D E D E D E D E E E D E D E D E D E D E D E D E D E D E D
E D E D E D E D E D E D E E E D E D E D E D E D E D E D E D 3 3 E D E D E D E D E D E D E D E D E E E D E D E D E D E D E D E D E D E D E D E D E D E D E D E E E D E D E D E D E D E D E D E D E D E D
D D D D D D D D D D D D E E D D D D D D 7 D D D D D D D D D 3 3 D D D D D D D D D D D D D D D D E E D D D D D D D D D D D D D D D D D D D D D D D D D D D D E E D D D D D D D D D D D D D D D D D D D D
D D D D D D D D D D D D D D D D D D D 7 7 7 D D D D D D D D 3 3 D D D D D D D D D D D D D 7 D D D D D D D D D D D D D D D D D D D D D D D D D D D D D D D D D D D D D D D D D D D D D D D D D D D D D D
D D D D D D D D D D D D D D D D D D 7 7 7 7 7 D D D D D D D 3 3 D D D D D D D D D D D 7 7 7 7 7 D D D D D D D D D D D D D D D D D D D D D D D D D D D D D D D D D D D D D D D D D D D D D D D D D D D D
D D D D D D D D D D D D E E D D D D D 7 7 7 D D D D D D D D 3 3 D D D D D D D D D D D 7 7 7 7 7 E E D D D D D D D D D D D D D D D D D D D D D D D D D D D D E E D D D D D D D D D D D D D D D D D D D D
D D D D D D D D D D D D E E D D D D D D 7 D D D 3 3 3 3 3 3 3 3 3 3 3 3 3 3 3 3 3 3 3 3 3 3 3 3 3 3 3 3 3 3 3 3 3 3 3 3 3 3 3 3 3 3 3 3 3 3 D D D D D D D D E E D D D D D D D D D D D D D D D D D D D D
D D D D D D D D D D D D E E D D D D D D D D D D D D D D D D 3 3 D D D D D D D D D D D 7 7 7 7 7 E E D D D D D D D D D D D D D D D D D D 3 3 D D D D D D D D E E D D D D D D D D D D D D D D D D D D D D
D D D D D D D D D D D D D D D D D D D D D D D D D D D D D D 3 3 D D D D D D D D D D D 7 7 7 7 7 D D D D D D D D D D D D 3 3 D D D D D D 3 3 D D D D D D D D D D D D D D D 7 D D D D D D D D D D D D D D
D D D D D D D D D D D D D D D D D D D D D D D D D D D D D D 3 3 D D D D D D D D D D D D D 7 D D D D D D D D D D D D D D 3 3 D D D D D D 3 3 D D D D D D D D D D D D D D 7 7 7 D D D D D D D D D D D D D
D D D D D D D D D D D D E E D D D D D D D D D D D D D D D D 3 3 D D D D D D D D D D D D D D D D E E D D D D D D D D D D 3 3 D D D D D D 3 3 D D D D D D D D E E D D D 7 7 7 7 7 D D D D D D D D D D D D
D D D D D D D D D D D D E E D D D D D D D D D D D D D D D D 3 3 D D D D D D D D D D D D D D D D E E D D D D D D D D D D 3 3 D D D D D D 3 3 D D D D D D D D E E D D D D 7 7 7 D D D D D D D D D D D D D
D D D D D D D D D D D D E E D D D D D D D D D D D D D D D D 3 3 D D D D D D D D D D D D D D D D E E D D D D D D D D D D 3 3 D D D D D D 3 3 D D D D D D D D E E D D D D D 7 D D D D D D D D D D D D D D
D D D D D D D D D D D D D D D D D D D D D D D D D D D D D D 3 3 D D D D D D D D D D D D D D D D D D D D D D D D D D D D 3 3 D D D D D D 3 3 D D D D D D D D D D D D D D D D D D D D D D D D D D D D D D
D D D D D D D D D D D D D D D D D D D D E E E E E E E E E E 3 3 E E F E E E E E E E E E E E E E F E E E E E E E E E E E 3 3 E E E E E E 3 3 E E E E E E E E F E E E E E E E E E E E D D D D D D D D D D
D D D D D D D D D D D D E E D D D D D D D D D D D D D D D D 3 3 D D D D D D D D D D D D D D D D E E D D D D D D D D D D 3 3 D D D D D D 3 3 D D D D D D D D E E D D D D D D D D D D D D D D D D D D D D
D D D D D D D D D D D D E E D D D D D D E E E E E E E E E E 3 3 E E E E E E E E E E E E E E E E E E E E E E E E E E E E 3 3 E E E E E E 3 3 E E E E E E E E E E E E E E E E E E E E D D D D D D D D D D
D D D D D D D D D D D D E E D D D D D D D D D D D D D D D D 3 3 C C D D D D D D D D D D D D D D E E D D D D D D D D D D 3 3 D D D D D D 3 3 D D D D D D D D E E D D D D D D D D D C C C D D D D D D D D
D D D D D D D D D D D D D D D D D D D D D D D D D D D D D D 3 3 C C C C C C C C C C C C C C C C C C C C C C C C C C C C 3 3 C C C C C C C C C C C C C C C C C C C C C C C C C C C C C C D D D D D D D D
D D D D D D D D D D D D D D D D D D D D D D D D D D D D D D 3 3 C C 3 3 3 3 3 3 3 3 3 3 3 3 3 3 3 3 3 3 3 3 3 3 3 3 3 3 3 3 3 3 3 3 3 3 3 3 3 3 3 3 3 3 3 3 3 3 3 3 3 3 3 3 3 3 3 C C C D D D D D D D D
D D D D D D D D D D D D E E D D D D D D D D D D D D D D D D 3 3 C 3 3 3 3 3 3 3 3 3 3 3 3 3 3 3 3 3 3 3 3 3 3 3 3 3 3 3 3 3 3 3 3 3 3 3 3 3 3 3 3 3 3 3 3 3 3 3 3 3 3 3 3 3 3 3 3 3 C D D D D D D D D D
D D D D D D D D D D D D E E D 7 D D D D D D D D D D D D D D 3 3 C 3 3 3 3 3 3 3 3 3 3 3 3 3 3 3 3 3 3 3 3 3 3 3 3 E E E F F F E E E 3 3 3 3 3 3 3 3 3 3 3 3 3 3 3 3 3 3 3 3 3 3 3 3 C D D D D D D D D D
D D D D D D D D D D D D E E 7 7 7 7 D D D D D D D D D D D D 3 3 C 3 3 3 3 3 3 3 3 3 3 3 3 3 3 3 3 3 3 3 3 3 3 3 3 E E E F F F E E E 3 3 3 3 3 3 3 3 3 3 3 3 3 3 3 3 3 3 3 3 3 3 3 3 C D D D D D D D D D
D D D D D D D D D D D D D 7 7 7 7 7 D D D D D D D D D D D D 3 3 C 3 3 3 3 3 3 3 3 3 3 3 3 3 3 3 3 3 3 3 3 3 3 3 3 E E E F F F E E E 3 3 3 3 3 3 3 3 3 3 3 3 3 3 3 3 3 3 3 3 3 3 3 3 C D D D D D D D D D
D D D D D D D D D D D D 7 7 7 7 7 7 7 D D D D D D D D D D D 3 3 C 3 3 3 3 3 3 3 3 3 3 3 3 3 3 3 3 3 3 3 3 3 3 3 E E E E F F F E E E E 3 3 3 3 3 3 3 3 3 3 3 3 3 3 3 3 3 3 3 3 3 3 3 C D D D D D D D D D
D D D D D D D D D D D D E E 7 7 7 7 D D D D D D D D D D D D 3 3 C 3 3 3 3 3 3 3 3 3 3 3 3 3 3 3 3 3 3 3 3 3 3 3 3 E E E F F F E E E 3 3 3 3 3 3 3 3 3 3 3 3 3 3 3 3 3 3 3 3 3 3 3 3 C D D D D D D D D D
D D D D D D D D D D D D E E 7 7 7 7 D D D D D D D D D D D D 3 3 C 3 3 3 3 3 3 3 3 3 3 3 3 3 3 3 3 3 3 3 3 3 3 3 3 E E E F F F E E E 3 3 3 3 3 3 3 3 3 3 3 3 3 3 3 3 3 3 3 3 3 3 3 3 C D D D D D D D D D
D D D D D D D D D D D D E E D 7 D D D D D D D D D D D D D D 3 3 C 3 3 3 3 3 3 3 3 3 3 3 3 3 3 3 3 3 3 3 3 3 3 3 3 3 3 3 3 3 3 3 3 3 3 3 3 3 3 3 3 3 3 3 3 3 3 3 3 3 3 3 3 3 3 3 3 3 C D D D D D D D D D
D D D D D D D D D D D D D D D D D D D D D D D D D D D D D D 3 3 C 3 3 3 3 3 3 3 3 3 3 3 3 3 3 3 3 3 3 3 3 3 3 3 3 3 3 3 3 3 3 3 3 3 3 3 3 3 3 3 3 3 3 3 3 3 3 3 3 3 3 3 3 3 3 3 3 3 C D D D D D D D D D
D D D D D D D D D D D D D D D D D D D D D D D D D D D D D D 3 3 C C 3 3 3 3 3 3 3 3 3 3 3 3 3 3 3 3 3 3 3 3 3 3 3 3 3 3 3 3 3 3 3 3 3 3 3 3 3 3 3 3 3 3 3 3 3 3 3 3 3 3 3 3 3 3 3 C C C D D D D D D D D
D D D D D D D D D D D D E E D D D D D D D D D D D D D D D D 3 3 C C C C C C C C C C C C C C C C C C C C C C C C C C C C C C C C C C C C C C C C C C C C C C C C C C C C C C C C C C C C D D D D D D D D
D D D D D D D D D D D D E E D D D D D D D D D D D D D D D D 3 3 C C D D D D D D D D D D D D D D E E D D D D D D D D D D D D D D D D D D D 7 7 7 D D D D D D E E D D D D D D D D D C C C D D D D D D D D
D D D D D D D D D D D D E E D D D D D D D D D D D D D D D D 3 3 D D D D D D D D D D D D D D D D E E D D D D D D D D D D D D D D D D D D 7 7 7 7 7 D D D D D E E D D D D D D D D D D D D D D D D D D D D
D D D D D D D D D D D D D D D D D D D D D D D D D D D D D D 3 3 D D D D D D D D D D D D D D D D D D D D D D D D D D D D D D D D D D D D D 7 7 7 D D D D D D D D D D D D D D D D D D D D D D D D D D D D

; Recursos
R 12 11 1 1
R 13 12 2 1
R 11 12 3 1
R 14 12 1 1
R 12 13 2 1
R 13 13 3 1
