100 100
1 2 2 2 2 2 2 2 2 1 2 2 2 2 2 2 2 1 1 2 2 2 2 2 2 2 2 1 2 2 2 2 2 2 2 2 2 2 2 2 2 2 2 2 2 2 2 2 2 2 2 2 2 2 2 2 2 2 2 2 2 2 2 2 2 2 2 2 2 2 2 2 2 2 2 2 2 2 2 2 2 2 2 2 2 2 2 2 2 2 2 2 2 2 2 2 2 2 2 2
2 0 0 0 0 0 0 0 1 0 0 0 0 1 3 0 0 1 0 0 0 0 0 2 2 2 1 4 4 4 6 5 4 4 4 4 4 4 4 5 4 4 4 4 4 4 4 5 4 6 4 4 4 4 5 5 4 4 4 4 4 4 4 5 4 4 4 4 4 A A 8 A 8 8 8 9 8 8 8 8 8 8 8 8 9 8 8 8 8 8 8 8 8 9 8 8 8 8 2
2 0 0 0 0 3 0 1 0 1 0 0 0 0 0 0 1 0 0 0 0 0 0 2 2 1 1 4 4 4 5 4 4 4 4 4 4 4 5 5 4 6 4 4 4 4 5 4 4 4 4 4 4 4 5 4 4 4 4 4 6 4 5 4 4 4 4 4 4 A 8 9 A 8 8 8 8 8 8 8 9 8 8 8 8 8 8 8 8 9 8 8 8 8 8 8 8 8 9 2
2 0 0 0 0 1 1 0 0 0 0 0 0 0 0 1 0 0 0 3 0 0 1 0 1 2 2 2 4 4 4 4 4 6 4 4 4 5 4 4 4 4 4 4 4 5 4 5 4 4 4 4 6 5 4 4 4 4 4 4 4 5 4 4 4 4 4 4 4 8 A A A 8 8 9 8 8 8 B 8 8 8 8 9 8 8 8 B 8 8 8 8 9 8 8 8 B 8 2
2 1 0 0 0 1 0 0 0 0 3 0 0 0 1 0 0 0 1 0 0 0 0 1 2 2 2 2 4 4 4 4 5 4 4 4 5 4 4 4 4 4 4 4 5 4 4 4 4 4 4 4 5 4 4 5 4 4 4 4 5 4 4 6 4 4 4 4 8 A 9 A 8 8 8 8 8 8 8 9 8 8 8 8 8 8 8 8 9 8 8 8 8 8 8 8 8 9 8 2
2 3 0 0 1 0 0 0 0 0 0 0 1 1 1 0 0 0 0 0 0 0 1 0 3 2 2 2 2 4 4 4 4 4 4 5 6 4 4 4 5 4 4 5 4 4 4 4 4 4 4 5 4 4 4 6 4 4 4 5 4 4 4 5 4 4 4 4 A A A A 8 8 9 8 8 8 8 8 8 8 8 9 8 8 8 8 8 8 8 8 9 8 8 8 8 8 8 2
2 0 0 1 0 0 0 0 0 0 1 0 1 1 0 3 0 0 0 0 0 1 0 0 0 2 2 1 2 4 4 4 4 4 5 4 4 4 4 4 4 4 5 4 4 4 4 6 5 4 5 4 4 4 4 4 4 4 5 4 4 4 4 4 4 4 4 4 A 9 A A 8 8 8 8 8 B 9 8 8 8 8 8 8 8 B 9 8 8 8 8 8 8 8 B 9 8 8 2
2 0 1 0 0 0 1 0 0 0 0 1 1 1 0 0 0 0 0 0 1 0 0 1 0 2 2 2 2 4 4 4 4 5 4 4 4 4 4 6 4 5 4 4 4 4 4 4 4 5 4 4 4 4 4 4 5 5 6 4 4 4 4 4 4 4 4 A A A A 8 8 9 8 8 8 8 8 8 8 8 9 8 8 8 8 8 8 8 8 9 8 8 8 8 8 8 8 2
2 1 1 0 0 0 0 0 0 0 1 0 1 1 0 0 0 0 0 1 3 0 0 0 0 0 2 2 1 2 4 6 5 4 4 4 4 4 4 4 5 5 4 4 4 4 4 4 5 4 6 4 4 4 4 4 5 4 4 4 4 4 4 4 5 4 4 A 9 A 8 8 8 8 8 8 8 9 8 8 8 8 8 8 8 8 9 8 8 8 8 8 8 8 8 9 8 8 8 2
1 0 0 0 0 0 0 0 0 1 0 3 1 1 0 1 0 0 1 0 0 0 1 1 1 0 2 1 2 2 4 5 4 4 4 4 4 4 4 5 4 4 6 4 4 4 4 5 4 5 4 4 4 4 4 5 4 4 4 4 4 6 4 5 4 4 4 A A 8 A 8 9 8 8 B 8 8 8 8 8 9 8 8 B 8 8 8 8 8 9 8 8 B 8 8 8 8 8 2
2 0 3 0 0 0 0 0 1 0 0 1 1 1 0 0 0 1 0 0 0 0 1 1 1 3 1 2 1 2 5 4 4 4 6 4 4 4 5 4 4 4 4 4 4 4 5 4 4 4 4 4 4 6 5 4 4 5 4 4 4 4 5 4 4 4 A 9 8 A 8 8 8 8 8 8 9 8 8 8 8 8 8 8 8 9 8 8 8 8 8 8 8 8 9 8 8 8 8 2
2 0 0 0 0 0 0 1 0 0 0 0 1 1 0 0 1 0 0 0 0 0 1 1 1 1 2 2 2 2 4 4 4 4 4 4 4 5 4 4 4 4 5 4 4 5 4 4 4 4 4 4 4 5 4 4 4 4 4 4 4 5 4 4 6 4 A 8 A A 8 9 8 8 8 8 8 8 8 8 9 8 8 8 8 8 8 8 8 9 8 8 8 8 8 8 8 8 9 2
2 0 0 1 0 0 1 3 0 0 0 0 1 1 0 1 0 0 0 0 1 0 0 0 1 0 2 2 2 2 4 4 4 4 4 4 5 6 4 4 4 4 4 4 5 4 4 4 4 4 5 4 5 4 4 4 6 4 4 4 5 5 4 4 4 4 9 A A A 8 8 8 B 8 9 8 8 8 8 8 8 B 8 9 8 8 8 8 8 8 B 8 9 8 8 8 8 8 2
2 0 0 0 0 1 0 0 0 0 0 0 1 1 1 0 1 0 0 0 0 3 0 1 0 0 0 2 2 2 2 4 4 4 4 5 4 4 4 4 4 4 5 5 4 4 4 4 6 4 4 5 4 4 4 4 4 4 5 5 4 4 4 4 4 8 A A A 8 9 8 8 8 8 8 8 8 8 9 8 8 8 8 8 8 8 8 9 8 8 8 8 8 8 8 8 9 8 2
2 0 0 0 1 0 0 0 0 0 0 0 1 1 0 0 0 0 0 0 0 0 1 1 1 1 0 2 2 1 2 4 4 4 5 4 4 4 4 4 5 4 5 5 4 4 4 4 4 4 5 4 4 4 4 4 4 5 5 6 4 4 4 4 4 9 A A A 8 8 8 8 8 9 8 8 8 8 8 8 8 8 9 8 8 8 8 8 8 8 8 9 8 8 8 8 8 8 2
2 0 0 1 0 0 0 3 1 0 0 0 1 1 0 0 0 0 0 0 0 1 0 1 1 1 3 2 2 2 2 4 6 5 4 4 4 4 5 4 4 5 4 4 4 4 4 4 4 5 4 6 4 4 4 5 4 5 4 4 4 4 4 4 A A A A 8 9 8 B 8 8 8 8 8 8 9 8 B 8 8 8 8 8 8 9 8 B 8 8 8 8 8 8 9 8 B 2
2 0 1 0 1 0 0 0 0 0 0 1 1 1 0 0 0 3 0 0 1 1 0 1 1 1 0 0 2 1 2 2 5 4 4 4 5 4 4 4 5 4 4 6 4 4 4 4 5 4 4 4 4 5 4 5 5 4 4 5 4 4 6 4 A A A A 8 8 8 8 8 9 8 8 8 8 8 8 8 8 9 8 8 8 8 8 8 8 8 9 8 8 8 8 8 8 8 2
1 1 0 0 0 0 0 0 3 0 1 1 1 0 0 0 0 1 0 1 0 0 0 0 1 0 0 0 1 2 2 2 4 4 5 6 4 4 4 5 4 4 4 4 5 4 4 5 4 4 4 5 4 4 6 5 4 4 4 4 4 4 4 5 A A A 8 9 8 8 8 8 8 8 8 8 9 8 8 8 8 8 8 8 8 9 8 8 8 8 8 8 8 8 9 8 8 8 2
1 0 0 0 0 0 0 0 0 1 0 1 1 1 0 0 0 0 1 0 0 0 3 0 0 0 0 1 0 2 2 2 2 4 4 4 7 4 5 4 4 4 4 4 4 4 5 4 4 5 4 4 5 4 7 4 4 4 4 4 4 4 5 4 A A 8 A 8 B 8 8 9 8 8 8 8 8 B 8 8 9 8 8 8 8 8 B 8 8 9 8 8 8 8 8 B 8 8 2
2 0 0 0 0 0 0 0 1 1 1 1 0 3 0 0 0 1 0 0 0 0 0 0 0 1 1 1 0 2 2 2 2 4 4 4 4 5 6 4 4 4 4 4 4 5 4 5 4 4 4 4 4 5 4 4 4 6 4 4 5 5 4 4 A 8 A 9 8 8 8 8 8 8 8 8 9 8 8 8 8 8 8 8 8 9 8 8 8 8 8 8 8 8 9 8 8 8 8 2
2 0 0 0 3 1 0 1 0 1 1 1 0 0 0 0 1 0 0 0 0 0 1 0 0 1 1 1 0 2 2 2 2 4 4 4 5 4 4 4 4 4 4 4 5 5 4 4 4 6 4 4 5 4 4 4 4 4 4 4 5 4 4 A A A A 8 8 B 8 9 8 8 8 8 8 8 8 8 9 8 8 8 B 8 8 8 8 9 8 8 8 8 8 8 8 8 9 2
2 1 0 0 0 0 1 0 0 1 1 0 0 0 0 1 0 0 1 0 0 0 0 0 1 1 1 1 0 0 2 2 2 2 4 5 4 4 4 4 4 6 4 5 4 4 4 4 4 4 4 5 4 5 4 4 4 4 4 5 5 4 4 A A A 9 B 8 8 8 8 8 8 8 9 B 8 8 8 8 8 8 8 9 B 8 8 8 8 8 8 8 9 B 8 8 8 8 2
2 0 0 0 0 1 0 0 0 1 1 0 0 0 1 0 0 0 0 0 0 0 0 1 0 0 0 1 0 0 2 2 2 2 5 4 4 4 5 4 4 5 5 4 4 4 4 4 4 4 5 4 6 4 4 4 4 4 5 4 4 5 A A A A 8 8 8 8 9 8 8 8 8 8 8 8 8 9 8 8 8 8 8 8 8 8 9 8 8 8 8 8 8 8 8 9 8 2
2 0 0 0 1 0 0 0 0 1 1 0 0 1 0 0 0 0 0 0 0 0 1 3 0 0 0 1 0 0 2 2 2 2 4 4 4 4 4 5 4 5 4 4 6 4 5 4 4 5 4 4 4 4 4 4 5 5 5 4 4 4 A A A 9 8 8 8 8 8 8 8 8 9 8 8 8 8 8 8 8 8 9 8 8 8 8 8 8 8 8 9 8 8 8 8 8 8 2
2 0 0 1 0 0 1 0 1 1 0 0 1 0 3 0 0 0 0 0 0 1 0 1 0 0 0 1 1 1 2 2 2 2 4 4 6 5 4 4 5 4 4 4 4 4 4 4 5 4 4 4 4 4 5 6 5 4 4 4 4 4 A A A A 8 8 8 9 8 8 8 8 B 8 8 8 9 8 8 8 8 B 8 8 8 9 8 8 8 8 B 8 8 8 9 8 8 2
2 0 1 0 0 3 0 0 1 1 0 1 0 0 0 0 0 0 0 1 1 0 0 0 0 0 0 1 1 1 0 2 2 2 2 4 4 4 4 5 4 4 4 4 4 4 4 5 4 4 4 4 5 4 4 5 4 4 4 4 4 A A A A 8 8 8 8 8 8 8 8 9 8 8 8 8 8 8 8 8 9 8 8 8 8 8 8 8 8 9 8 8 8 8 8 8 8 2
2 1 0 0 0 0 0 1 1 0 1 0 0 0 0 1 0 0 0 1 0 0 0 0 0 0 0 1 1 1 0 2 2 2 2 4 4 4 5 6 4 4 4 4 4 4 5 5 4 4 5 4 4 4 5 4 4 4 6 4 4 A A A A 8 8 8 9 8 8 8 8 8 8 8 8 9 8 8 8 8 8 8 8 8 9 8 8 8 8 8 8 8 8 9 8 8 8 2
1 0 0 0 0 0 0 1 1 1 3 1 0 0 0 0 0 0 1 0 0 0 0 0 0 0 0 1 1 0 0 2 2 2 2 4 4 5 4 4 4 4 4 4 4 5 4 4 5 4 6 4 4 5 4 5 4 4 4 4 4 A A A A 8 8 8 8 8 8 8 9 8 8 8 8 8 8 8 8 9 8 8 8 8 8 8 8 8 9 8 8 8 8 8 8 8 8 2
2 3 0 0 0 0 1 1 1 0 0 0 0 0 0 0 0 1 0 0 0 0 0 0 1 0 1 0 0 0 0 2 2 2 2 4 5 4 4 4 5 4 6 4 5 4 5 4 4 4 4 4 5 4 4 4 4 4 4 4 A A A A 8 8 8 9 8 8 8 8 8 8 8 8 9 8 8 8 8 8 8 8 8 9 9 9 9 9 9 8 8 8 9 8 8 8 8 2
2 0 0 1 0 0 1 1 0 0 0 0 0 0 0 3 1 0 0 0 1 0 0 0 0 1 0 1 1 1 0 2 2 2 2 5 4 4 4 4 4 4 4 5 5 4 4 4 5 4 4 5 4 6 4 4 4 4 4 5 A A A A 8 8 8 8 8 8 8 9 8 8 8 8 8 8 8 8 9 8 8 8 8 8 9 9 9 9 9 8 8 8 8 8 8 8 9 2
2 0 0 0 0 0 1 1 0 0 0 0 0 0 0 1 1 0 0 0 0 0 0 0 1 0 0 1 1 1 0 2 2 2 2 4 4 4 7 4 4 4 5 4 5 6 6 6 5 4 5 4 4 4 4 4 7 4 5 4 A A A A 8 8 B 8 8 8 B 8 8 8 8 9 8 8 8 B 8 B 8 8 9 8 9 9 9 9 9 8 8 9 8 8 8 B 8 2
2 0 0 0 0 1 1 1 0 0 0 0 1 0 1 0 0 0 0 0 3 0 0 1 0 0 0 1 1 1 0 2 2 2 2 4 4 6 4 4 5 5 4 4 6 6 6 6 6 5 4 4 4 4 4 4 6 5 4 A A A A 8 8 8 8 8 8 8 9 8 8 8 8 8 8 8 8 9 8 8 8 8 8 8 9 9 9 9 9 8 8 8 8 8 8 9 8 2
2 0 0 0 1 0 1 1 1 0 0 3 0 1 0 0 0 0 0 0 0 0 1 0 0 1 0 0 0 1 0 2 2 2 2 4 4 4 5 4 5 4 4 4 6 6 6 6 6 5 4 4 4 4 4 5 5 4 4 A A A A 8 8 9 8 8 8 8 8 8 8 8 9 8 8 8 8 8 8 8 8 9 8 8 9 9 9 9 9 8 9 8 8 8 8 8 8 2
2 0 3 1 1 0 1 1 0 3 0 0 1 0 0 0 0 0 0 0 0 1 0 0 0 3 0 0 0 0 0 2 2 2 2 4 5 4 5 5 6 4 4 4 6 6 6 6 6 4 4 4 4 5 4 5 4 5 4 A A A A 8 8 8 8 8 B 9 8 8 8 8 8 8 8 B 9 8 8 8 8 8 8 8 B 9 9 8 8 8 8 8 8 B 9 8 8 2
1 0 1 0 0 0 1 1 0 0 0 1 0 0 0 0 3 1 0 0 1 0 0 0 0 0 0 1 1 1 0 2 2 2 2 4 4 4 5 4 4 4 5 4 5 6 6 6 5 4 4 5 4 4 5 4 4 4 4 A A A A 8 8 8 8 8 8 8 8 8 8 9 8 8 8 8 8 8 8 8 9 8 8 8 8 8 8 8 8 9 8 8 8 8 8 8 8 2
2 1 0 0 0 0 1 1 0 0 1 0 0 1 0 0 0 0 0 1 0 0 0 0 0 0 0 1 1 1 0 2 2 2 2 4 4 5 4 4 4 4 4 6 4 5 4 4 4 5 5 4 4 5 4 4 4 4 4 A A A A 8 8 8 8 8 9 8 8 8 8 8 8 8 8 9 8 8 8 8 8 8 8 8 9 8 8 8 8 8 8 8 8 9 8 8 8 2
1 0 0 0 0 0 1 1 0 1 0 0 0 0 0 0 0 0 1 0 0 3 0 0 0 0 1 1 1 1 0 2 2 2 2 6 5 4 4 4 4 4 4 4 5 4 4 5 4 4 4 4 5 4 6 4 4 4 5 A A A A 8 8 8 B 8 8 8 8 8 9 8 8 B 8 8 8 8 8 9 8 8 B 8 8 8 8 8 9 8 8 B 8 8 8 8 8 2
2 0 0 0 0 1 1 1 1 0 0 0 3 0 0 0 0 1 0 0 0 0 1 0 0 0 1 0 1 0 0 2 2 2 2 5 4 4 4 4 4 4 4 5 4 5 6 4 4 4 4 5 4 4 4 4 4 4 4 A A A A 8 8 8 8 9 8 8 8 8 8 8 8 8 9 8 8 8 8 8 8 8 8 9 8 8 8 8 8 8 8 8 9 8 8 8 8 2
2 1 0 3 0 0 1 1 0 0 0 0 0 0 0 0 1 0 1 0 0 0 0 0 0 1 3 1 0 0 0 2 2 2 2 4 4 4 6 4 4 4 5 5 4 4 4 4 4 4 5 5 4 4 4 4 4 6 5 A A A A 8 8 8 8 8 8 8 8 9 8 8 8 8 9 9 9 9 9 8 8 8 8 8 8 8 8 9 8 8 8 8 8 8 8 8 9 2
2 0 0 0 0 0 1 1 1 0 0 0 0 0 1 1 0 3 0 0 0 0 0 0 1 0 0 1 1 1 0 2 2 2 2 4 5 4 4 4 4 5 4 4 4 4 4 4 4 5 4 4 4 4 4 4 4 5 4 A A A A 8 8 8 9 8 8 8 8 8 8 B 8 9 9 9 9 9 9 8 B 8 9 8 8 8 8 8 8 B 8 9 8 8 8 8 8 2
2 0 0 0 0 1 0 1 1 0 1 0 0 0 1 0 0 0 0 0 0 0 0 1 0 0 0 1 1 1 0 2 2 2 2 4 4 4 4 5 5 5 4 4 5 4 4 4 5 4 4 4 4 4 4 4 5 4 4 A A A A 8 8 B 8 8 8 8 9 8 8 8 8 8 9 9 9 9 9 8 8 8 8 8 8 8 9 8 8 8 8 8 8 B 8 9 8 2
2 0 0 0 1 0 1 0 1 1 0 0 0 1 0 0 0 0 0 0 0 0 1 1 0 0 0 1 1 1 0 2 2 2 2 4 4 5 4 5 4 4 4 4 4 4 4 5 4 4 4 4 6 4 5 5 4 4 4 A A A A 8 8 9 8 8 8 8 8 8 8 8 9 8 9 9 9 9 9 8 8 9 8 8 8 8 8 8 8 8 9 8 8 8 8 8 8 2
2 0 1 1 0 0 0 0 1 1 3 0 1 3 0 0 0 0 0 1 0 1 0 0 0 0 0 1 0 0 0 2 2 2 2 4 4 5 7 4 4 4 4 4 6 4 5 4 4 4 4 4 5 4 5 4 4 4 4 A A A A 8 8 8 8 8 8 9 8 B 8 8 8 8 9 9 9 9 9 8 8 8 8 8 8 9 8 B 8 8 8 8 8 8 9 8 B 2
2 0 1 0 3 0 0 0 0 1 1 1 0 0 0 1 0 0 0 0 1 0 0 0 0 0 0 3 1 1 2 2 2 2 4 4 6 5 4 4 4 4 4 4 4 5 4 4 4 4 5 4 4 5 4 6 4 4 4 A A A A 8 8 8 8 8 8 8 8 8 8 9 8 8 8 8 9 8 8 8 9 8 8 8 8 8 8 8 8 9 8 8 8 8 8 8 8 2
2 1 0 0 0 0 0 0 0 1 1 1 0 0 0 0 0 0 3 1 0 0 0 0 0 0 1 1 1 0 2 2 2 2 4 4 5 4 4 4 4 4 4 4 5 4 4 6 5 4 4 4 5 5 4 4 4 4 4 A A A A 8 8 8 8 8 9 8 8 8 8 8 8 8 8 9 8 8 8 8 8 8 8 8 9 8 8 8 8 8 8 8 8 9 8 8 8 2
1 0 0 0 0 0 0 1 0 1 1 0 0 0 0 0 0 0 1 0 0 0 0 0 1 0 1 1 1 0 2 2 2 2 4 5 4 4 5 6 4 4 4 5 4 4 5 4 4 4 4 5 4 4 4 4 4 4 6 A A A A 8 8 8 8 8 8 B 8 8 9 8 8 8 8 8 B 8 8 9 8 8 8 8 8 B 8 8 9 8 8 8 8 8 B 8 8 2
2 0 0 1 0 0 0 0 1 0 1 1 0 0 0 0 0 1 0 0 1 0 0 3 0 0 1 1 1 0 2 2 2 2 5 4 4 4 4 4 4 4 5 4 5 4 5 4 4 4 5 4 4 4 4 4 4 4 5 A A A A 8 8 8 8 9 8 8 8 8 8 8 8 8 9 8 8 8 8 8 8 8 8 9 8 8 8 8 8 8 8 8 9 8 8 8 8 2
2 0 0 0 0 0 0 1 0 0 1 1 0 0 3 0 1 0 0 0 0 0 0 0 0 1 1 0 0 2 2 2 2 5 4 4 4 4 4 4 4 5 5 4 5 4 4 4 4 5 4 4 4 4 5 4 4 5 4 A A A A 8 8 8 8 8 8 8 8 9 8 8 8 8 8 8 8 8 9 8 8 8 8 8 8 8 8 9 8 8 8 8 8 8 8 8 9 2
2 0 0 0 0 0 0 0 0 0 0 1 1 0 0 0 0 0 0 0 0 0 0 0 0 0 0 0 0 2 2 2 2 4 4 4 4 4 4 4 5 4 4 4 4 4 4 4 4 4 4 4 4 4 4 4 4 5 4 4 A A A A 8 8 8 8 8 8 8 8 8 8 8 8 8 8 8 8 8 8 8 8 8 8 8 8 8 8 8 8 8 8 8 8 8 8 8 2
2 0 0 0 0 0 0 0 0 0 0 1 1 0 0 0 0 0 0 0 0 0 0 0 1 1 1 0 0 2 2 2 2 4 4 4 4 4 5 4 4 2 4 4 4 4 4 4 4 4 2 4 4 4 4 5 4 4 4 2 A A A A 8 8 8 8 A 8 8 8 8 8 8 8 8 A 8 8 8 8 8 8 8 8 A 8 8 8 8 8 8 8 8 8 8 8 8 2
2 0 0 0 0 C C C C C C C 1 1 C C C C C C C C C C 1 1 1 C C C C C C C C C C C C C C C C C C C C C C C C 6 6 6 C C C C C C C C C C C C B C C C C C C C C C C C C C C B C C C C C C C C C C C C C 8 8 8 8 2
2 0 0 0 0 C C C C C C 3 1 1 C C C C C C C C C C 1 1 1 C C C C C C C C C C C C C C C C C C C C C C C 6 6 6 6 6 C C C C C C C C C C C C C C C C C C C C C C C C C C C C C C C C C C C C C C C C 8 8 8 8 2
2 0 0 0 0 0 0 0 0 0 0 0 1 1 0 0 0 0 0 0 0 0 0 0 0 0 0 0 2 2 2 2 2 4 4 4 4 4 4 4 4 2 4 4 4 4 4 4 4 5 6 6 6 6 6 4 4 4 4 2 4 A A A A 8 8 8 A 8 8 8 8 8 8 8 8 A 8 8 8 8 8 8 8 8 A 8 8 8 8 8 8 8 8 8 8 8 8 2
2 1 0 0 0 0 3 0 0 1 1 0 1 1 0 0 0 0 0 1 0 0 0 0 1 0 1 2 1 2 2 4 6 5 4 5 4 4 4 4 4 4 4 5 4 4 4 5 4 4 6 6 6 6 6 4 5 4 4 5 4 A A A A 8 8 8 9 8 8 8 8 8 8 8 8 9 8 8 8 8 8 8 8 8 9 8 8 8 8 8 8 8 8 9 8 8 8 2
1 0 0 0 0 1 0 0 0 1 0 0 1 1 0 0 0 0 1 0 3 0 1 1 1 0 0 1 2 2 2 4 4 4 7 4 4 4 4 4 4 5 5 6 4 5 4 5 4 4 5 6 6 6 5 4 4 4 5 4 4 4 A A A A 8 8 8 8 8 8 9 8 8 8 8 8 8 8 8 9 8 8 9 9 9 9 9 8 9 8 8 8 8 8 8 8 8 2
2 1 0 0 0 0 0 0 1 0 0 3 1 1 0 0 0 1 1 0 0 0 1 1 1 0 1 2 2 2 4 4 4 5 4 6 4 4 4 4 4 5 4 5 4 4 4 4 4 5 4 6 4 4 6 4 4 5 4 4 5 4 A A A 8 8 9 8 8 8 8 8 8 8 8 9 8 8 8 8 8 8 8 9 9 9 9 9 8 8 8 8 8 9 8 8 8 8 2
2 0 3 0 0 0 0 1 0 0 0 0 1 1 1 0 1 0 0 0 0 0 1 1 1 1 2 2 2 2 4 4 5 4 5 4 4 4 4 4 5 5 4 4 4 4 6 4 5 4 4 4 4 4 4 4 5 5 5 4 4 4 A A A A 8 8 8 8 8 9 8 8 8 8 8 8 8 8 9 8 8 8 9 9 9 9 9 9 8 8 8 8 8 8 8 8 9 2
2 0 0 0 0 0 1 0 0 0 1 0 1 1 0 1 3 0 0 0 0 0 0 0 1 0 2 1 2 2 4 5 4 4 4 4 4 4 6 5 4 4 5 4 4 4 4 5 4 4 4 4 4 4 4 5 5 6 4 4 4 4 4 A A A 9 8 8 8 B 8 8 8 8 9 8 8 8 B 8 8 8 8 9 9 9 9 9 8 8 8 8 9 8 8 8 B 8 2
2 0 0 0 0 1 1 3 0 0 0 0 1 1 1 0 0 0 0 0 0 0 0 1 0 0 2 2 2 2 5 4 4 4 4 4 4 5 5 4 4 4 4 4 4 4 5 4 4 6 5 4 4 4 5 4 4 4 4 4 4 4 5 A A A A 8 8 8 9 8 8 8 8 8 8 8 8 9 8 8 8 8 9 9 9 9 9 8 8 8 8 8 8 8 8 9 8 2
2 0 1 0 1 0 0 0 0 0 0 0 1 1 0 0 0 0 0 1 0 1 1 1 0 0 2 2 2 2 4 4 4 4 4 5 4 5 4 4 4 6 4 4 4 5 4 4 4 4 4 4 5 5 4 4 4 4 5 4 6 5 4 4 A 9 A 8 8 8 8 8 8 8 9 8 8 8 8 8 8 8 8 9 8 8 8 9 8 8 8 8 9 8 8 8 8 8 8 2
2 0 0 1 0 0 0 0 0 0 0 1 1 1 0 1 0 0 0 0 0 1 1 1 0 2 2 2 2 4 4 4 4 5 4 4 5 4 4 4 4 4 4 5 5 4 4 4 4 4 5 4 5 4 4 4 4 4 4 4 5 4 4 4 A A 8 A B 9 B 8 8 8 8 8 8 B 9 8 8 8 8 8 8 B B 9 8 8 8 8 8 8 8 B 9 8 8 2
2 0 1 3 0 0 0 0 0 0 0 1 1 0 0 0 0 0 0 0 1 1 1 1 0 2 2 2 1 4 4 5 4 4 4 5 4 4 4 4 4 4 4 5 6 4 4 4 5 4 5 5 4 4 4 4 4 4 4 5 4 4 4 6 A 8 A A 8 8 8 8 8 9 8 8 8 8 8 8 8 8 9 8 8 8 8 8 8 8 8 9 8 8 8 8 8 8 8 2
2 1 0 0 0 0 0 1 0 0 1 1 1 0 0 0 0 3 0 1 0 0 0 1 1 2 2 2 1 4 4 4 4 4 5 4 6 4 4 4 4 4 5 4 4 4 5 4 4 4 5 4 4 4 4 6 4 4 5 5 4 4 4 4 A A A A 9 8 8 8 8 8 8 8 8 9 8 8 8 8 8 8 8 8 9 8 8 8 8 8 8 8 8 9 8 8 8 2
1 0 0 1 0 0 0 0 3 1 1 1 0 0 0 0 0 0 1 0 1 0 0 0 2 2 2 1 4 4 4 4 4 5 4 4 4 4 4 4 4 5 4 4 5 4 4 6 4 5 4 4 4 4 4 4 4 5 4 4 4 5 4 4 A A A A 8 8 8 8 9 8 8 B 8 8 8 8 8 9 8 8 B 8 8 8 8 8 9 8 8 B 8 8 8 8 8 2
2 0 0 0 0 0 0 0 1 0 1 1 0 0 0 0 1 1 0 1 1 1 3 0 2 2 1 2 4 4 4 4 5 4 4 4 4 4 4 6 5 4 5 4 4 4 4 4 5 4 4 4 5 4 4 4 5 4 6 5 4 4 4 4 5 A A 9 8 8 8 8 8 8 8 8 9 8 8 8 8 8 8 8 8 9 8 8 8 8 8 8 8 8 9 8 8 8 8 2
2 0 0 0 0 0 0 1 0 1 1 0 1 3 0 0 1 0 0 1 1 1 0 2 2 1 2 4 4 4 4 5 4 4 4 4 4 5 4 5 5 4 4 4 4 4 4 5 4 4 6 4 4 4 4 5 4 5 4 4 5 4 4 5 4 A A 8 A 8 8 9 8 8 8 8 8 8 8 8 9 8 8 8 8 8 8 8 8 9 8 8 8 8 8 8 8 8 9 2
2 0 0 0 3 0 1 0 1 1 1 0 0 0 0 1 0 0 0 1 1 1 0 2 1 1 2 4 4 4 7 4 4 4 4 4 4 4 5 4 4 4 6 4 4 5 5 6 6 6 5 4 4 4 5 5 4 4 4 4 4 6 5 4 4 4 9 A A A 8 8 8 B 8 9 8 8 8 8 8 8 B 8 9 8 8 8 8 8 8 B 8 9 8 8 8 8 8 2
2 0 0 0 1 1 0 0 0 1 1 0 0 0 1 0 0 0 3 0 0 1 0 1 2 2 2 4 4 4 5 4 4 4 6 4 5 5 4 4 4 4 4 4 4 5 6 6 6 6 6 4 4 5 4 4 4 4 4 4 4 5 4 4 4 4 A A A A 9 8 8 8 8 8 8 8 8 9 8 8 8 8 8 8 8 8 9 8 8 8 8 8 8 8 8 9 8 2
1 0 0 0 1 0 0 0 1 1 0 0 0 1 0 0 0 1 0 0 0 0 1 2 2 2 2 4 4 4 4 4 4 4 5 4 5 4 5 4 4 4 4 4 5 6 6 6 6 6 6 5 5 5 4 4 4 4 4 4 5 5 4 4 6 4 A A A A 8 8 8 8 9 8 8 8 8 8 8 8 8 9 8 8 8 8 8 8 8 8 9 8 8 8 8 8 8 2
2 0 0 1 0 0 0 0 1 1 0 0 1 3 0 0 0 0 1 1 1 1 2 2 2 2 4 4 4 4 4 4 5 4 4 5 4 6 4 4 4 4 4 5 4 4 6 6 6 6 6 5 4 4 4 4 6 4 4 5 4 4 4 4 4 4 4 A A 9 A B 8 8 8 8 8 8 9 8 B 8 8 8 8 8 8 9 8 B 8 8 8 8 8 8 9 8 B 2
2 0 1 0 0 0 0 1 1 1 0 1 0 0 3 0 0 0 1 1 1 0 2 2 2 2 4 4 4 4 5 5 4 4 5 4 4 4 4 4 4 4 5 4 4 4 5 6 6 6 5 4 4 4 5 4 4 4 5 4 4 4 4 4 5 4 4 A 8 A A 8 9 9 9 9 9 8 8 8 8 8 9 8 8 8 8 8 B 8 8 9 8 8 8 8 8 8 8 2
2 1 0 0 0 1 1 1 1 0 1 0 0 0 0 0 0 0 1 1 1 0 1 2 2 2 4 4 5 4 5 4 4 5 4 4 4 4 4 5 6 5 4 4 4 5 4 4 4 6 5 4 4 4 4 4 4 5 4 6 4 4 5 4 4 4 4 8 9 A A 8 9 9 9 9 9 9 8 8 8 8 8 8 8 8 9 8 8 8 8 8 8 8 8 9 8 8 8 2
1 1 0 0 0 0 1 1 0 1 0 0 0 0 0 0 0 0 1 3 0 2 2 2 2 4 5 4 4 4 4 4 5 4 4 4 4 4 4 4 5 4 4 5 4 4 4 5 5 4 4 6 4 4 4 4 5 4 4 4 5 4 4 4 5 4 4 4 A A A A 9 9 9 9 9 8 B 8 8 9 8 8 8 8 8 B 8 8 9 8 8 8 8 8 B 8 8 2
2 0 0 0 0 0 1 1 1 0 3 0 0 0 1 0 0 1 0 0 0 2 2 2 2 4 4 4 4 4 4 5 5 4 4 4 4 4 4 5 4 5 4 6 4 4 4 5 4 4 4 4 4 4 4 5 4 4 5 4 4 4 6 5 4 4 4 4 A A A 8 8 9 9 9 9 8 8 8 8 8 8 8 8 9 8 8 8 8 8 8 8 8 9 8 8 8 8 2
2 3 0 0 0 0 1 1 0 0 1 0 0 0 0 0 1 1 1 1 0 2 2 2 2 4 4 4 4 4 5 4 4 4 4 6 4 4 5 5 5 4 4 4 4 4 5 4 4 4 4 4 4 4 5 4 5 4 4 4 4 4 5 5 4 4 4 4 A A 8 9 8 9 9 9 9 8 8 8 9 8 8 8 8 8 8 8 8 9 8 8 8 8 8 8 8 8 9 2
2 0 0 0 0 0 1 1 0 0 0 0 0 0 0 1 0 1 1 1 0 2 2 1 1 4 4 4 4 4 4 4 4 4 4 4 4 5 4 4 4 4 4 4 4 5 6 4 5 4 4 4 4 5 5 4 5 4 4 4 4 5 4 4 4 4 4 4 4 8 A A A 8 8 9 9 8 8 8 8 8 8 8 9 B 8 8 8 8 8 8 8 9 B 8 8 8 8 2
2 0 1 0 0 1 1 1 0 0 0 0 0 0 1 0 0 1 1 1 0 2 2 1 2 4 4 4 4 4 4 4 4 5 4 5 5 4 6 4 4 4 4 4 5 4 4 4 4 4 4 4 5 4 4 4 5 6 4 4 5 4 4 4 4 4 4 4 4 A 9 A A 8 8 8 8 8 8 9 8 8 8 8 8 8 8 8 9 8 8 8 8 8 8 8 8 9 8 2
2 0 0 0 1 0 1 1 0 0 0 0 0 1 0 1 0 0 0 0 3 2 1 2 2 4 4 4 4 4 6 4 4 5 4 5 4 4 4 4 4 5 4 5 4 4 4 4 4 6 5 5 4 4 4 4 4 4 4 5 4 4 4 4 5 4 4 5 4 A A A A 8 9 8 8 8 8 8 8 8 8 9 8 8 8 8 8 8 8 8 9 8 8 8 8 8 8 2
2 0 0 1 0 0 1 1 0 0 0 1 1 0 0 0 0 1 0 0 0 1 2 2 2 4 4 4 7 4 4 5 4 5 5 4 4 4 4 4 4 6 5 4 4 4 7 4 5 5 5 4 4 4 4 4 4 4 5 4 6 4 4 4 7 5 4 4 4 9 A A 8 8 B 8 8 8 9 8 8 8 8 B 8 8 8 9 8 8 8 8 B 8 8 8 9 8 8 2
2 0 1 0 0 0 1 1 0 0 0 1 0 0 0 0 0 1 1 1 1 2 2 2 1 4 4 4 4 5 4 4 4 5 5 4 4 4 4 4 4 5 4 4 4 4 5 4 4 5 4 4 6 4 4 4 4 5 4 4 4 4 4 5 4 4 4 4 4 A A 8 A 9 8 8 8 8 8 8 8 8 9 8 8 8 8 8 8 8 8 9 8 8 8 8 8 8 8 2
2 1 0 1 0 0 1 1 0 0 1 0 0 0 0 0 3 1 1 1 1 2 2 2 2 4 4 5 4 4 4 4 5 4 4 4 4 4 4 4 5 4 5 4 5 4 4 4 5 4 4 4 4 4 4 4 5 4 4 4 4 5 4 6 5 4 4 4 4 A 8 A A 8 8 B 8 9 8 8 8 8 8 8 8 8 9 8 8 8 B 8 8 8 8 9 8 8 8 2
1 0 0 0 0 0 1 1 0 1 0 0 0 0 0 0 1 1 1 1 0 2 2 2 2 4 4 4 4 4 4 5 4 4 4 4 6 4 4 5 4 4 5 4 4 4 4 5 4 4 5 4 4 4 4 5 4 4 4 5 4 4 4 5 4 4 4 4 4 8 A A 9 8 8 8 8 8 8 8 8 9 8 8 8 8 8 8 8 8 9 8 8 8 8 8 8 8 8 2
2 0 0 0 0 0 1 1 1 0 0 0 1 0 0 0 0 1 0 1 0 2 2 2 2 4 4 4 4 4 5 4 4 4 4 5 4 4 5 4 5 4 4 4 4 4 5 6 4 4 4 4 4 4 5 4 4 5 5 5 4 4 5 4 4 4 4 4 4 A A A A 8 8 8 9 8 8 8 8 8 8 8 8 9 8 8 8 8 8 8 8 8 9 8 8 8 8 2
2 0 0 0 0 0 1 1 1 0 0 0 3 0 0 0 1 0 1 0 0 2 2 2 2 4 4 4 4 4 4 4 4 4 4 4 4 5 5 6 4 4 4 5 4 5 4 4 4 4 4 4 4 5 4 5 4 4 6 4 4 5 4 4 4 4 4 4 4 A A 9 A 8 8 8 8 8 8 8 9 8 8 8 8 8 8 8 8 9 8 8 8 8 8 8 8 8 9 2
2 0 0 3 1 0 1 1 1 0 0 0 0 0 0 1 0 1 1 1 0 1 2 2 1 4 4 4 4 4 4 6 4 4 4 4 5 4 4 4 4 4 4 4 5 4 4 4 4 4 6 5 5 5 4 4 4 4 4 4 5 4 4 4 4 4 4 4 4 A A A 8 8 8 9 8 8 8 B 8 8 8 8 9 8 8 8 B 8 8 8 8 9 8 8 8 B 8 2
1 0 0 0 0 1 0 0 1 1 0 0 0 0 1 0 0 1 1 1 0 2 2 1 2 4 4 4 4 4 4 4 4 4 5 5 5 4 4 4 4 4 6 5 4 4 4 4 4 4 4 5 4 4 4 4 4 4 4 5 4 6 4 4 4 4 4 4 4 A 9 8 A 8 8 8 8 8 8 9 8 8 8 8 8 8 8 8 9 8 8 8 8 8 8 8 8 9 8 2
2 0 0 0 1 0 0 0 1 1 0 0 0 1 0 0 0 1 1 1 0 2 1 2 2 4 4 4 4 4 4 4 5 4 5 4 4 4 4 4 4 4 5 4 5 4 4 4 4 5 5 4 4 6 4 4 4 4 5 4 4 4 4 4 4 4 5 4 4 A 8 A A 8 9 8 8 8 8 8 8 8 8 9 8 8 8 8 8 8 8 8 9 8 8 8 8 8 8 2
2 0 0 1 0 0 0 0 0 1 1 0 1 0 0 0 0 0 1 0 0 1 2 2 2 4 4 4 4 4 5 4 4 5 4 4 4 4 4 4 4 5 4 4 4 6 4 5 4 5 4 4 5 4 4 4 4 5 4 4 4 4 4 4 5 4 4 4 4 9 A A A 8 8 8 8 B 9 8 8 8 8 8 8 8 B 9 8 8 8 8 8 8 8 B 9 8 8 2
2 0 1 0 0 1 0 0 0 1 1 1 0 3 0 0 0 0 0 0 1 2 1 2 2 4 4 4 4 4 4 4 5 4 4 4 4 6 4 4 5 4 4 4 4 4 4 4 5 4 4 4 4 4 4 4 5 4 4 4 5 4 4 4 5 4 4 4 4 A A A A 9 8 8 8 8 8 8 8 8 9 8 8 8 8 8 8 8 8 9 8 8 8 8 8 8 8 2
2 1 0 0 3 0 0 0 0 1 1 0 0 0 0 0 0 0 1 1 0 2 2 2 2 4 4 4 4 4 4 5 4 4 4 4 4 4 4 5 4 4 4 4 4 5 4 5 6 4 4 4 4 4 4 5 4 4 4 4 4 4 4 5 4 4 4 4 4 A A A A 8 8 8 8 9 8 8 8 8 8 8 8 8 9 8 8 8 8 8 8 8 8 9 8 8 8 2
1 0 0 0 0 0 0 0 0 1 1 1 0 0 1 0 0 0 1 0 0 0 2 2 2 2 4 4 4 4 5 4 4 4 4 4 4 4 5 4 6 4 4 4 4 4 5 4 4 4 4 4 4 5 5 4 4 4 4 6 4 4 5 4 4 4 4 4 4 A A A 9 8 8 B 8 8 8 8 8 9 8 8 B 8 8 8 8 8 9 8 8 B 8 8 8 8 8 2
2 0 0 0 0 0 0 0 1 3 1 1 0 0 0 0 0 1 0 0 0 0 2 2 2 2 4 4 4 4 4 4 6 4 4 4 4 5 5 4 4 4 4 4 4 5 4 4 4 4 4 6 4 5 4 4 4 4 4 4 4 5 4 4 4 4 4 4 4 A A 8 A 8 8 8 9 8 8 8 8 8 8 8 8 9 8 8 8 8 8 8 8 8 9 8 8 8 8 2
2 0 0 0 0 0 1 1 0 0 0 1 1 0 0 0 1 0 0 0 0 0 2 1 2 1 4 4 4 4 4 4 4 4 4 4 5 4 4 4 4 4 4 6 5 4 5 4 4 4 4 4 5 4 4 4 4 4 4 4 5 4 6 4 4 4 4 4 A A 8 9 8 8 8 8 8 8 8 8 9 8 8 8 8 8 8 8 8 9 8 8 8 8 8 8 8 8 9 2
2 0 1 0 0 0 1 0 0 0 0 1 1 0 3 1 0 0 0 1 0 0 2 2 1 2 4 4 4 4 4 5 4 4 4 5 4 4 4 4 4 4 4 5 4 4 4 4 4 4 4 5 4 4 6 4 4 4 4 5 4 4 4 4 4 4 4 4 A 8 A A 8 B 8 9 8 8 8 8 8 8 B 8 9 8 8 8 8 8 8 B 8 9 8 8 8 8 8 2
2 0 0 0 0 1 0 0 0 0 0 1 0 0 1 1 0 0 0 0 0 0 0 1 2 2 2 4 4 4 4 4 4 4 5 4 4 4 4 5 4 4 5 4 4 4 6 4 4 4 5 4 4 4 4 4 4 4 5 4 4 4 5 4 4 4 4 4 8 A 9 A 8 8 8 8 8 8 8 9 8 8 8 8 8 8 8 8 9 8 8 8 8 8 8 8 8 9 8 2
2 0 0 0 1 0 0 0 0 0 0 1 0 1 0 0 0 0 0 3 0 0 1 2 2 2 2 4 4 4 4 4 4 5 4 4 4 4 6 4 4 5 4 4 4 4 4 5 4 5 4 4 4 4 4 4 4 5 4 4 4 4 4 4 4 4 4 8 A A A 8 8 8 9 8 8 8 8 8 8 8 8 9 8 8 8 8 8 8 8 8 9 8 8 8 8 8 8 2
2 0 0 1 0 0 0 1 0 0 3 0 1 0 0 0 0 0 0 0 0 1 0 2 1 2 2 4 4 4 6 4 5 4 4 4 4 4 4 4 5 4 4 4 4 4 4 4 5 6 4 4 4 4 4 5 5 4 4 4 4 4 4 4 5 4 4 A A 9 A B 8 8 8 8 8 8 9 8 B 8 8 8 8 8 8 9 8 B 8 8 8 8 8 8 9 8 B 2
2 3 1 1 0 0 0 0 0 0 0 1 0 0 0 0 0 0 0 0 1 0 0 0 2 2 2 2 4 4 4 5 4 4 4 4 4 4 4 5 5 6 4 4 4 4 4 5 4 4 4 4 4 4 4 5 4 4 4 4 6 4 4 5 4 4 4 A A A A 8 8 9 8 8 8 8 8 8 8 8 9 8 8 8 8 8 8 8 8 9 8 8 8 8 8 8 8 2
2 1 0 0 0 0 0 0 0 0 1 0 0 0 0 3 1 0 0 1 0 0 0 0 2 2 2 2 4 4 5 4 4 6 4 4 4 4 5 4 4 4 4 4 4 4 5 4 5 4 4 4 6 4 5 4 4 4 4 4 4 4 5 4 4 4 A A 9 A 8 8 8 8 8 8 8 9 8 8 8 8 8 8 8 8 9 8 8 8 8 8 8 8 8 9 8 8 8 2
1 2 2 2 2 2 2 2 2 1 2 2 1 2 2 2 2 2 1 2 2 2 2 2 2 2 2 1 2 1 2 2 2 2 2 2 2 2 2 2 2 2 2 2 2 2 2 2 2 2 2 2 2 2 2 2 2 2 2 2 2 2 2 2 2 2 2 2 2 2 2 2 2 2 2 2 2 2 2 2 2 2 2 2 2 2 2 2 2 2 2 2 2 2 2 2 2 2 2 2R 12 60 1 1
R 20 80 1 1
R 26 35 1 1
R 28 55 1 1
R 40 25 2 1
R 42 65 2 1
R 52 30 2 1
R 59 80 2 1
R 60 50 2 1
R 73 20 3 1
R 78 45 3 1
R 82 70 3 1
R 89 35 3 1
R 92 85 3 1
