100 100
0 2 2 2 0 1 2 2 0 2 2 2 0 2 2 1 0 2 2 2 0 2 2 2 0 1 2 2 0 2 2 2 0 4 4 4 4 4 4 4 4 4 4 4 4 4 7 4 C C C C 4 4 4 4 4 4 4 4 4 4 4 4 4 4 8 8 8 8 8 8 9 8 8 8 8 8 8 8 9 8 8 8 8 8 8 8 9 8 8 8 8 8 8 8 9 8 8 8
0 0 0 0 0 1 0 0 0 0 0 0 0 0 0 1 0 0 0 0 0 0 0 0 0 1 0 0 0 0 0 0 0 4 4 4 4 4 4 4 4 4 4 4 4 7 4 4 C C C C 4 4 4 4 4 4 4 4 4 4 4 4 4 4 8 8 8 8 8 8 9 8 B 8 8 8 8 8 9 8 8 8 8 8 8 8 9 8 8 8 8 8 8 8 9 8 8 8
0 0 0 0 0 0 0 0 0 0 0 0 0 0 0 0 0 0 0 0 0 0 0 0 0 0 0 0 0 0 0 0 0 4 4 4 4 4 4 4 4 4 4 4 7 4 4 4 C C C C 4 4 4 4 4 4 4 4 4 4 4 4 4 4 A A A A A A A A B A A A A A A A A A A A A A A A A A A A A A A A A A
0 0 0 0 0 0 0 0 0 0 0 0 0 0 0 0 0 0 0 0 0 0 0 0 0 0 0 0 0 0 0 0 0 4 4 4 4 4 4 4 4 4 4 7 4 4 4 4 C C C C 4 4 4 4 4 4 4 4 4 4 4 4 4 4 A A A A A A A A B A A A A A A A A A A A A A A A A A A A A A A A A A
0 0 0 0 0 1 0 0 0 0 0 0 0 0 0 1 0 0 0 0 0 0 0 0 0 1 0 0 0 0 0 0 0 5 5 5 5 5 5 5 5 5 7 5 5 5 5 5 C C C C 5 5 5 5 5 5 5 5 5 5 5 5 5 7 8 8 8 8 8 8 8 8 B 8 8 8 8 8 8 8 8 8 8 8 8 8 8 8 8 8 8 8 8 8 8 8 8 8
3 0 0 0 0 1 0 3 0 0 0 0 0 0 3 1 0 0 0 0 0 3 0 0 0 1 0 0 3 0 0 0 0 4 4 4 4 4 4 4 4 7 4 4 4 4 4 4 C C C C 4 4 4 4 4 4 4 4 4 4 4 4 7 4 8 8 8 8 8 8 9 8 B 8 8 8 8 8 9 8 8 8 8 8 8 8 9 8 8 8 8 8 8 8 9 8 8 8
0 0 0 0 0 1 0 0 0 0 0 0 0 0 0 1 0 0 0 0 0 0 0 0 0 1 0 0 0 0 0 0 0 4 4 4 4 4 4 4 7 4 4 4 4 4 4 4 C C C C 4 4 4 4 4 4 4 4 4 4 4 7 4 4 8 8 8 8 8 8 9 8 B 8 8 8 8 8 9 8 8 8 8 8 8 8 9 8 8 8 8 8 8 8 9 8 8 8
0 0 0 0 0 1 0 0 0 0 0 0 0 0 0 1 0 0 0 0 0 0 0 0 0 1 0 0 0 0 0 0 0 4 4 5 5 4 4 7 5 5 4 4 4 5 5 4 C C C C 4 4 4 5 5 4 4 4 5 5 7 4 4 5 8 8 8 8 8 8 8 8 8 8 8 8 8 8 8 8 8 8 8 8 8 8 8 8 8 8 8 8 8 8 8 8 8 8
0 0 0 0 0 0 0 0 0 0 0 0 0 0 0 0 0 0 0 0 0 0 0 0 0 0 0 0 0 0 0 0 0 4 4 4 4 4 7 4 4 4 4 4 4 4 4 4 C C C C 4 4 4 4 4 4 4 4 4 7 4 4 4 4 8 8 8 8 8 8 8 8 B 8 8 8 8 8 8 8 8 8 8 8 8 8 8 8 8 8 8 8 8 8 8 8 8 8
0 0 0 0 0 0 0 0 0 0 0 0 0 0 0 0 0 0 0 0 0 0 0 0 0 0 0 0 0 0 0 0 0 4 4 4 4 7 4 4 4 4 4 4 4 4 4 4 C C C C 4 4 4 4 4 4 4 4 7 4 4 4 4 4 8 8 8 8 8 8 8 8 B 8 8 8 8 8 8 8 8 8 8 8 8 8 8 8 8 8 8 8 8 8 8 8 8 8
0 2 2 2 0 1 2 2 0 2 2 2 0 2 2 1 0 2 2 2 0 2 2 2 0 1 2 2 0 2 2 2 0 4 4 4 7 4 4 4 4 4 4 4 4 4 4 4 C C C C 4 4 4 4 4 4 4 7 4 4 4 4 4 4 8 8 8 8 8 8 9 8 B 8 8 8 8 8 9 8 8 8 8 8 8 8 9 8 8 8 8 8 8 8 9 8 8 8
0 0 0 0 0 1 0 0 0 0 0 0 0 0 0 1 0 0 0 0 0 0 0 0 0 1 0 0 0 0 0 0 0 4 4 7 4 4 4 4 4 4 4 4 4 6 4 4 C C C C 6 4 4 4 4 4 7 6 4 4 4 4 4 4 A A A A A A 9 A B A A A A A 9 A A A A A A A 9 A A A A A A A 9 A A A
0 0 0 0 0 1 0 0 0 0 0 0 0 0 0 1 0 0 0 0 0 0 0 0 0 1 0 0 0 0 0 0 0 4 7 4 4 4 4 4 4 4 4 4 6 4 4 4 C C C C 4 4 4 4 4 7 6 4 4 4 4 4 4 4 A A A A A A A A B A A A A A A A A A A A A A A A A A A A A A A A A A
0 0 0 0 0 1 0 0 0 0 0 0 0 0 0 1 0 0 0 0 0 0 0 0 0 1 0 0 0 0 0 0 0 7 4 4 4 4 4 4 4 4 4 6 4 4 4 4 C C C C 4 4 4 4 7 6 4 4 4 4 4 4 4 4 8 8 8 8 8 8 8 8 B 8 8 8 8 8 8 8 8 8 8 8 8 8 8 8 8 8 8 8 8 8 8 8 8 8
0 0 0 0 0 0 0 0 0 0 0 0 0 0 0 0 0 0 0 0 0 0 0 0 0 0 0 0 0 0 0 0 0 4 4 4 4 4 4 4 4 4 6 4 4 4 4 4 C C C C 4 4 4 7 6 4 4 4 4 4 4 4 4 4 8 8 8 8 8 8 8 8 8 8 8 8 8 8 8 8 8 8 8 8 8 8 8 8 8 8 8 8 8 8 8 8 8 8
0 0 0 0 0 0 0 0 0 0 0 0 0 0 0 0 0 0 0 0 0 0 0 0 0 0 0 0 0 0 0 0 0 4 4 4 4 4 4 4 4 6 4 4 4 4 4 4 C C C C 4 4 7 6 4 4 4 4 4 4 4 4 4 4 8 8 8 8 8 8 9 8 B 8 8 8 8 8 9 8 8 8 8 8 8 8 9 8 8 8 8 8 8 8 9 8 8 8
0 0 0 0 0 1 0 0 0 0 0 0 0 0 0 1 0 0 0 0 0 0 0 0 0 1 0 0 0 0 0 0 0 5 5 5 5 5 5 5 6 5 5 5 5 5 5 6 C C C C 5 7 6 5 5 5 5 5 5 5 5 5 5 5 8 8 8 8 8 8 9 8 B 8 8 8 8 8 9 8 8 8 8 8 8 8 9 8 8 8 8 8 8 8 9 8 8 8
0 0 0 0 0 1 0 0 0 0 0 0 0 0 0 1 0 0 0 0 0 0 0 0 0 1 0 0 0 0 0 0 0 4 4 4 4 4 4 6 4 4 4 4 4 4 6 4 C C C C 7 6 4 4 4 4 4 4 4 4 4 4 4 4 8 8 8 8 8 8 8 8 B 8 8 8 8 8 8 8 8 8 8 8 8 8 8 8 8 8 8 8 8 8 8 8 8 8
3 0 0 0 0 1 1 3 1 1 1 0 0 0 3 1 0 0 0 0 0 3 0 0 0 1 0 0 3 0 0 0 0 4 4 4 4 4 4 4 4 4 4 4 4 4 4 4 C C C C 4 4 4 4 4 4 4 4 4 4 4 4 4 4 8 8 8 8 8 8 8 8 B 8 8 8 8 8 8 8 8 8 8 8 8 8 8 8 8 8 8 8 8 8 8 8 8 8
0 0 0 0 0 1 1 1 1 1 1 0 0 0 0 1 0 0 0 0 0 0 0 0 0 1 0 0 0 0 0 0 0 4 4 4 4 4 4 4 4 4 4 4 4 4 4 4 C C C C 4 4 4 4 4 4 4 4 4 4 4 4 4 4 8 8 8 8 8 8 8 8 B 8 8 8 8 8 8 8 8 8 8 8 8 8 8 8 8 8 8 8 8 8 8 8 8 8
0 2 2 2 0 2 1 1 1 1 1 2 0 2 2 2 0 2 2 2 0 2 2 2 0 2 2 2 0 2 2 2 0 4 4 4 4 4 4 4 4 4 4 4 4 4 4 4 C C C C 4 4 4 4 4 4 4 4 4 4 4 4 4 4 A A A A A A 9 A B A A A A A 9 A A A A A A A 9 A A A A A A A 9 A A A
0 0 0 0 0 0 1 1 1 1 1 0 0 0 0 0 0 0 0 0 0 0 0 0 0 0 0 0 0 0 0 0 0 4 4 4 4 4 4 4 4 4 4 5 5 5 5 5 C C C C 4 4 4 4 4 4 4 4 4 4 4 4 4 4 A A A A A A 9 A A A A A A 9 9 9 A A A A A A 9 A A A A A A A 9 A A A
0 0 0 0 0 1 1 1 1 1 1 0 0 0 0 1 0 0 0 0 0 0 0 0 0 1 0 0 0 0 0 0 0 4 4 5 5 4 4 4 5 5 5 5 5 5 5 7 C C C C 4 4 4 5 5 4 4 4 5 5 4 4 4 5 8 8 8 8 8 8 8 8 B 8 8 8 9 9 9 9 9 8 8 8 8 8 8 8 8 8 8 8 8 8 8 8 8 8
0 0 0 0 0 1 0 0 0 0 0 0 0 0 0 1 0 0 0 0 0 0 0 0 0 1 0 0 0 0 0 0 0 4 4 4 4 4 4 4 4 5 5 5 5 5 7 5 C C C C 4 4 4 4 4 4 4 4 4 4 4 4 4 4 8 8 8 8 8 8 8 8 B 8 8 9 9 9 9 9 9 9 8 8 8 8 8 8 8 8 8 8 8 8 8 8 8 8
0 0 0 0 0 1 0 0 0 0 0 0 0 0 0 1 0 0 0 0 0 0 0 0 0 1 0 0 0 0 0 0 0 4 4 4 4 4 4 4 4 5 5 5 5 7 5 5 C C C C 4 4 4 4 4 4 4 4 4 4 4 4 4 4 8 8 8 8 8 8 8 8 B 8 9 9 9 9 9 9 9 9 9 8 8 8 8 8 8 8 8 8 8 8 8 8 8 8
0 0 0 0 0 1 0 0 0 0 0 0 0 0 0 1 0 0 0 0 0 0 0 0 0 1 0 0 0 0 0 0 0 4 4 4 4 4 4 4 4 5 5 5 7 5 5 5 C C C C 4 4 4 4 4 4 4 4 4 4 4 4 4 4 8 8 8 8 8 8 9 8 B 8 9 9 9 9 9 9 9 9 9 8 8 8 9 8 8 8 8 8 8 8 9 8 8 8
0 0 0 0 0 0 0 0 0 0 0 0 0 0 0 0 0 0 0 0 0 0 0 0 0 0 0 0 0 0 0 0 0 4 4 4 4 4 4 4 4 5 5 7 5 5 5 5 C C C C 4 4 4 4 4 4 4 4 4 4 4 4 4 4 8 8 8 8 8 8 9 8 B 8 9 9 9 9 9 9 9 9 9 8 8 8 9 8 8 8 8 8 8 8 9 8 8 8
0 0 0 0 0 0 0 0 0 0 0 0 0 0 0 0 0 0 0 0 0 0 0 0 0 0 0 0 0 0 0 0 0 4 4 4 4 4 4 4 4 5 7 5 5 5 5 5 C C C C 4 4 4 4 4 4 4 4 4 4 4 4 4 7 8 8 8 8 8 8 8 8 B 8 8 9 9 9 9 9 9 9 8 8 8 8 8 8 8 8 8 8 8 8 8 8 8 8
0 0 0 0 0 1 0 0 0 0 0 0 0 0 0 1 0 0 0 0 0 0 0 0 0 1 0 0 0 0 0 0 0 5 5 5 5 5 5 5 5 7 5 5 5 5 5 5 C C C C 5 5 5 5 5 5 5 5 5 5 5 5 7 5 8 8 8 8 8 8 8 8 8 8 8 8 9 9 9 9 9 8 8 8 8 8 8 8 8 8 8 8 8 8 8 8 8 8
0 0 0 0 0 1 0 0 0 0 0 0 0 0 0 1 0 0 0 0 0 0 0 0 0 1 0 0 0 0 0 0 0 4 4 4 4 4 4 4 7 4 4 5 5 5 5 5 C C C C 4 4 4 4 4 4 4 4 4 4 4 7 4 4 A A A A A A A A B A A A A 9 9 9 A A A A A A A A A A A A A A A A A A
0 2 2 2 0 1 2 2 0 2 2 2 0 2 2 1 0 2 2 2 0 2 2 2 0 1 2 2 0 2 2 2 0 4 4 4 4 4 4 7 4 4 4 4 4 4 4 4 C C C C 4 4 4 4 4 4 4 4 4 4 7 4 4 4 A A A A A A 9 A B A A A A A 9 A A A A A A A 9 A A A A A A A 9 A A A
3 0 0 0 0 1 0 3 0 0 0 0 0 0 3 1 0 0 0 0 0 3 0 0 0 1 0 0 3 0 0 0 0 4 4 4 4 4 7 4 4 4 4 4 4 4 4 4 C C C C 4 4 4 4 4 4 4 4 4 7 4 4 4 4 8 8 8 8 8 8 9 8 B 8 8 8 8 8 9 8 8 8 8 8 8 8 9 8 8 8 8 8 8 8 9 8 8 8
0 0 0 0 0 0 0 0 0 0 0 0 0 0 0 0 0 0 0 0 0 0 0 0 0 0 0 0 0 0 0 0 0 4 4 4 4 7 4 4 4 4 4 4 4 4 4 4 C C C C 4 4 4 4 4 4 4 4 7 4 4 4 4 4 8 8 8 8 8 8 8 8 B 8 8 8 8 8 8 8 8 8 8 8 8 8 8 8 8 8 8 8 8 8 8 8 8 8
0 0 0 0 0 0 0 0 0 0 0 0 0 0 0 0 0 0 0 0 0 0 0 0 0 0 0 0 0 0 0 0 0 4 4 4 7 4 4 4 4 4 4 4 4 4 4 4 C C C C 4 4 4 4 4 4 4 7 4 4 4 4 4 4 8 8 8 8 8 8 8 8 B 8 8 8 8 8 8 8 8 8 8 8 8 8 8 8 8 8 8 8 8 8 8 8 8 8
0 0 0 0 0 1 0 0 0 0 0 0 0 0 0 1 0 0 0 0 0 0 0 0 0 1 0 0 0 0 0 0 0 4 4 7 4 4 4 4 4 4 4 4 4 4 4 4 C C C C 4 4 4 4 4 4 7 4 4 4 4 4 4 4 8 8 8 8 8 8 8 8 B 8 8 8 8 8 8 8 8 8 8 8 8 8 8 8 8 8 8 8 8 8 8 8 8 8
0 0 0 0 0 1 0 0 0 0 0 0 0 0 0 1 0 0 0 0 0 0 0 0 0 1 0 0 0 0 0 0 0 4 7 4 4 4 4 4 4 4 4 4 4 4 4 4 C C C C 4 4 4 4 4 7 4 4 4 4 4 4 4 4 8 8 8 8 8 8 9 8 8 8 8 8 8 8 9 8 8 8 8 8 8 8 9 8 8 8 8 8 8 8 9 8 8 8
0 0 0 0 0 1 0 0 0 0 0 0 0 0 0 1 0 0 0 0 0 0 0 0 0 1 0 0 0 0 0 0 0 7 4 4 4 4 4 4 4 4 4 4 4 4 4 4 C C C C 4 4 4 4 7 4 4 4 4 4 4 4 4 4 8 8 8 8 8 8 9 8 B 8 8 8 8 8 9 8 8 8 8 8 8 8 9 8 8 8 8 8 8 8 9 8 8 8
0 0 0 0 0 1 0 0 0 0 0 0 0 0 0 1 0 0 0 0 0 0 0 0 0 1 0 0 0 0 0 0 0 4 4 5 5 4 4 4 5 5 4 4 4 5 5 4 C C C C 4 4 4 7 5 4 4 4 5 5 4 4 4 5 B B B B B B B B B B B B B B B B B B B B B B B B B B B B B B B B B B
0 0 0 0 0 0 0 0 0 0 0 0 0 0 0 0 0 0 0 0 0 0 0 0 0 0 0 0 0 0 0 0 0 4 4 4 4 4 4 4 4 4 4 4 4 4 4 4 C C C C 4 4 7 4 4 4 4 4 4 4 4 4 4 4 A A A A A A A A B A A A A A A A A A A A A A A A A A A A A A A A A A
0 0 0 0 0 0 0 0 0 0 0 0 0 0 0 0 0 0 0 0 0 0 0 0 0 0 0 0 0 0 0 0 0 4 4 4 4 4 4 4 4 4 4 4 4 4 4 4 C C C C 4 7 4 4 4 4 4 4 4 4 4 4 4 4 A A A A A A A A B A A A A A A A A A A A A A A A A A A A A A A A A A
0 2 2 2 0 1 2 2 0 2 2 2 0 2 2 1 0 2 2 2 0 2 2 2 0 1 2 2 0 2 2 2 0 5 5 5 5 5 5 5 5 5 5 5 5 5 5 5 C C C C 7 5 5 5 5 5 5 5 5 5 5 5 5 5 8 8 8 8 8 8 9 8 B 8 8 8 8 8 9 8 8 8 8 8 8 8 9 8 8 8 8 8 8 8 9 8 8 8
0 0 0 0 0 1 0 0 0 0 0 0 0 0 0 1 0 0 0 0 0 0 0 0 0 1 0 0 0 0 0 0 0 4 4 4 4 4 4 4 4 4 4 4 4 4 4 4 C C C C 4 4 4 4 4 4 4 4 4 4 4 4 4 4 8 8 8 8 8 8 9 8 B 8 8 8 8 8 9 8 8 8 8 8 8 8 9 8 8 8 8 8 8 8 9 8 8 8
0 0 0 0 0 1 0 0 0 0 0 0 0 0 0 1 0 0 0 0 0 0 0 0 0 1 0 0 0 0 0 0 0 4 4 4 4 4 4 4 4 4 4 4 4 4 4 4 C C C C 4 4 4 4 4 4 4 4 4 4 4 4 4 4 8 8 8 8 8 8 8 8 8 8 8 8 8 8 8 8 8 8 8 8 8 8 8 8 8 8 8 8 8 8 8 8 8 8
0 0 0 0 0 1 0 0 0 0 0 0 0 0 0 1 0 0 0 0 0 0 0 0 0 1 0 0 0 0 0 0 0 4 4 4 4 4 4 4 4 4 4 4 4 4 4 4 C C C C 4 4 4 4 4 4 4 4 4 4 4 4 4 4 8 8 8 8 8 8 8 8 B 8 8 8 8 8 8 8 8 8 8 8 8 8 8 8 8 8 8 8 8 8 8 8 8 8
3 0 0 0 0 0 0 3 0 0 0 0 0 0 3 0 0 0 0 0 0 3 0 0 0 0 0 0 3 0 0 0 0 4 4 4 4 4 4 4 4 4 4 4 4 4 4 4 C C C C 4 4 4 4 4 4 4 4 4 4 4 4 4 4 8 8 8 8 8 8 8 8 B 8 8 8 8 8 8 8 8 8 8 8 8 8 8 8 8 8 8 8 8 8 8 8 8 8
C C C C C C C C C C C C C C C C C C C C C C C C C C C C C C C C C C C C C C C C C C C C C C C C C C C C C C C C C C C C C C C C C C C C C C C C C C C C C C C C C C C C C C C C C C C C C C C C C C C C
C C C C C C C C C C C C C C C C C C C C C C C C C C C C C C C C C C C C C C C C C C C C C C C C C C C C C C C C C C C C C C C C C C C C C C C C C C C C C C C C C C C C C C C C C C C C C C C C C C C C
C C C C C C C C C C C C C C C C C C C C C C C C C C C C C C C C C C C C C C C C C C C C C C C C C C C C C C C C C C C C C C C C C C C C C C C C C C C C C C C C C C C C C C C C C C C C C C C C C C C C
C C C C C C C C C C C C C C C C C C C C C C C C C C C C C C C C C C C C C C C C C C C C C C C C C C C C C C C C C C C C C C C C C C C C C C C C C C C C C C C C C C C C C C C C C C C C C C C C C C C C
C C C C C C C C C C C C C C C C C C C C C C C C C C C C C C C C C C C C C C C C C C C C C C C C C C C C C C C C C C C C C C C C C C C C C C C C C C C C C C C C C C C C C C C C C C C C C C C C C C C C
C C C C C C C C C C C C C C C C C C C C C C C C C C C C C C C C C C C C C C C C C C C C C C C C C C C C C C C C C C C C C C C C C C C C C C C C C C C C C C C C C C C C C C C C C C C C C C C C C C C C
C C C C C C C C C C C C C C C C C C C C C C C C C C C C C C C C C C C C C C C C C C C C C C C C C C C C C C C C C C C C C C C C C C C C C C C C C C C C C C C C C C C C C C C C C C C C C C C C C C C C
C C C C C C C C C C C C C C C C C C C C C C C C C C C C C C C C C C C C C C C C C C C C C C C C C C C C C C C C C C C C C C C C C C C C C C C C C C C C C C C C C C C C C C C C C C C C C C C C C C C C
C C C C C C C C C C C C C C C C C C C C C C C C C C C C C C C C C C C C C C C C C C C C C C C C C C C C C C C C C C C C C C C C C C C C C C C C C C C C C C C C C C C C C C C C C C C C C C C C C C C C
C C C C C C C C C C C C C C C C C C C C C C C C C C C C C C C C C C C C C C C C C C C C C C C C C C C C C C C C C C C C C C C C C C C C C C C C C C C C C C C C C C C C C C C C C C C C C C C C C C C C
0 0 0 0 0 1 0 0 0 0 0 0 0 0 0 1 0 0 0 0 0 0 0 0 0 1 0 0 0 0 0 0 0 4 4 4 4 7 4 4 4 4 4 4 4 4 4 4 C C C C 4 4 4 4 4 4 4 4 7 4 4 4 4 4 8 8 8 8 8 8 9 8 B 8 8 8 8 8 9 8 8 8 8 8 8 8 9 8 8 8 8 8 8 8 9 8 8 8
0 0 0 0 0 0 0 0 0 0 0 0 0 0 0 0 0 0 0 0 0 0 0 0 0 0 0 0 0 0 0 0 0 4 4 4 7 4 4 4 4 4 4 4 4 4 4 4 C C C C 4 4 4 4 4 4 4 7 4 4 4 4 4 4 A A A A A A 9 A A A A A A A 9 A A A A A A A 9 A A A A A A A 9 A A A
3 0 0 0 0 0 0 3 0 0 0 0 0 0 3 0 0 0 0 0 0 3 0 0 0 0 0 0 3 0 0 0 0 4 4 7 4 4 4 4 4 4 4 4 4 4 4 4 C C C C 4 4 4 4 4 4 7 4 4 4 4 4 4 4 A A A A A A A A B A A A A A A A A A A A A A A A A A A A A A A A A A
0 0 0 0 0 1 0 0 0 0 0 0 0 0 0 1 0 0 0 0 0 0 0 0 0 1 0 0 0 0 0 0 0 4 7 4 4 4 4 4 4 4 4 4 4 4 4 4 C C C C 4 4 4 4 4 7 4 4 4 4 4 4 4 4 8 8 8 8 8 8 8 8 B 8 8 8 8 8 8 8 8 8 8 8 8 8 8 8 8 8 8 8 8 8 8 8 8 8
0 0 0 0 0 1 0 0 0 0 0 0 0 0 0 1 0 0 0 0 0 0 0 0 0 1 0 0 0 0 0 0 0 7 4 4 4 4 4 4 4 4 4 4 4 4 4 4 C C C C 4 4 4 4 7 4 4 4 4 4 4 4 4 4 8 8 8 8 8 8 8 8 B 8 8 8 8 8 8 8 8 8 8 8 8 8 8 8 8 8 8 8 8 8 8 8 8 8
0 2 2 2 0 1 2 2 0 2 2 2 0 2 2 1 0 2 2 2 0 2 2 2 0 1 2 2 0 2 2 2 0 4 4 4 4 4 4 4 4 4 4 4 4 4 4 4 C C C C 4 4 4 7 4 4 4 4 4 4 4 4 4 4 8 8 8 8 8 8 9 8 B 8 8 8 8 8 9 8 8 8 8 8 8 8 9 8 8 8 8 8 8 8 9 8 8 8
0 0 0 0 0 1 0 0 0 0 0 0 0 0 0 1 0 0 0 0 0 0 0 0 0 1 0 0 0 0 0 0 0 4 4 4 4 4 4 4 4 4 4 4 4 4 4 4 C C C C 4 4 7 4 4 4 4 4 4 4 4 4 4 4 8 8 8 8 8 8 9 8 B 8 8 8 8 8 9 8 8 8 8 8 8 8 9 8 8 8 8 8 8 8 9 8 8 8
0 0 0 0 0 0 0 0 0 0 0 0 0 0 0 0 0 0 0 0 0 0 0 0 0 0 0 0 0 0 0 0 0 4 4 4 4 4 4 4 4 4 4 4 4 4 4 4 C C C C 4 7 4 4 4 4 4 4 4 4 4 4 4 4 8 8 8 8 8 8 8 8 B 8 8 8 8 8 8 8 8 8 8 8 8 8 8 8 8 8 8 8 8 8 8 8 8 8
0 0 0 0 0 0 0 0 0 0 0 0 0 0 0 0 0 0 0 0 0 0 0 0 0 0 0 0 0 0 0 0 0 4 4 4 4 4 4 4 4 4 4 4 4 4 4 4 C C C C 7 4 4 4 4 4 4 4 4 4 4 4 4 4 8 8 8 8 8 8 8 8 8 8 8 8 8 8 8 8 8 8 8 8 8 8 8 8 8 8 8 8 8 8 8 8 8 8
0 0 0 0 0 1 0 0 0 0 0 0 0 0 0 1 0 0 0 0 0 0 0 0 0 1 0 0 0 0 0 0 0 5 5 5 5 5 5 5 5 5 5 5 5 5 5 5 C C C C 5 5 5 5 5 5 5 5 5 5 5 5 5 5 8 8 8 8 8 8 8 8 B 8 8 8 8 8 8 8 8 8 8 8 8 8 8 8 8 8 8 8 8 8 8 8 8 8
0 0 0 0 0 1 0 0 0 0 0 0 0 0 0 1 0 0 0 0 0 0 0 0 0 1 0 0 0 0 0 0 0 4 4 4 4 4 4 4 4 4 4 4 4 4 4 4 C C C C 4 4 4 4 4 4 4 4 4 4 4 4 4 4 A A A A A A 9 A B A A A A A 9 A A A A A A A 9 A A A A A A A 9 A A A
0 0 0 0 0 1 0 0 0 0 0 0 0 0 0 1 0 0 0 0 0 0 0 0 0 1 0 0 0 0 0 0 0 4 4 4 4 4 4 4 4 4 4 4 4 4 4 4 C C C C 4 4 4 4 4 4 4 4 4 4 4 4 4 4 A A A A A A 9 A B A A A A A 9 A A A A A A A 9 A A A A A A A 9 A A A
0 0 0 0 0 1 0 0 0 0 0 0 0 0 0 1 0 0 1 1 1 1 1 0 0 1 0 0 0 0 0 0 0 4 4 5 5 4 4 4 5 5 4 4 4 5 5 4 C C C C 4 4 4 5 5 4 4 4 5 5 4 4 4 5 8 8 8 8 8 8 8 8 B 8 8 8 8 8 8 8 8 8 8 8 8 8 8 9 9 9 8 8 8 8 8 8 8 8
0 0 0 0 0 0 0 0 0 0 0 0 0 0 0 0 0 1 1 1 1 1 1 1 0 0 0 0 0 0 0 0 0 4 4 4 4 4 4 4 4 4 4 4 4 4 4 7 C C C C 4 4 4 4 4 4 4 4 4 4 4 4 4 4 8 8 8 8 8 8 8 8 B 8 8 8 8 8 8 8 8 8 8 8 8 8 9 9 9 9 9 8 8 8 8 8 8 8
0 0 0 0 0 0 0 0 0 0 0 0 0 0 0 0 0 1 1 1 1 1 1 1 0 0 0 0 0 0 0 0 0 4 4 4 4 4 4 4 4 4 4 4 4 4 7 4 C C C C 4 4 4 4 4 4 4 4 4 4 4 4 4 4 8 8 8 8 8 8 8 8 B 8 8 8 8 8 8 8 8 8 8 8 8 9 9 9 9 9 9 9 8 8 8 8 8 8
3 2 2 2 0 1 2 3 0 2 2 2 0 2 3 1 0 1 1 1 1 3 1 1 0 1 2 2 3 2 2 2 0 4 4 4 4 4 4 4 4 4 4 4 4 7 4 4 C C C C 4 4 4 4 4 4 4 4 4 4 4 4 4 4 8 8 8 8 8 8 9 8 8 8 8 8 8 8 9 8 8 8 8 8 8 9 9 9 9 9 9 9 8 8 9 8 8 8
0 0 0 0 0 1 0 0 0 0 0 0 0 0 0 1 0 1 1 1 1 1 1 1 0 1 0 0 0 0 0 0 0 4 4 4 4 4 4 4 4 4 4 4 7 6 4 4 C C C C 4 4 6 5 5 4 4 4 4 4 4 4 4 4 8 8 8 8 8 8 9 8 B 8 8 8 8 8 9 8 8 8 8 8 8 9 9 9 9 9 9 9 8 8 9 8 8 8
0 0 0 0 0 1 0 0 0 0 0 0 0 0 0 1 0 1 1 1 1 1 1 1 0 1 0 0 0 0 0 0 0 4 4 4 4 4 4 4 4 6 6 7 6 6 6 6 C C C C 6 6 6 6 6 6 6 6 6 6 4 4 4 4 8 8 8 8 8 8 8 8 B 8 8 8 8 8 8 8 8 8 8 8 8 8 9 9 9 9 9 8 8 8 8 8 8 8
0 0 0 0 0 1 0 0 0 0 0 0 0 0 0 1 0 0 1 1 1 1 1 0 0 1 0 0 0 0 0 0 0 4 4 4 4 4 4 4 4 4 7 4 4 6 4 4 C C C C 5 5 6 5 5 5 5 4 4 4 4 4 4 7 8 8 8 8 8 8 8 8 B 8 8 8 8 8 8 8 8 8 8 8 8 8 8 9 9 9 8 8 8 8 8 8 8 8
0 0 0 0 0 0 0 0 0 0 0 0 0 0 0 0 0 0 0 0 0 0 0 0 0 0 0 0 0 0 0 0 0 4 4 4 4 4 4 4 4 7 4 4 4 6 4 4 C C C C 5 5 6 5 5 5 5 5 4 4 4 4 7 4 B B B B B B B B B B B B B B B B B B B B B B B B B B B B B B B B B B
0 0 0 0 0 0 0 0 0 0 0 0 0 0 0 0 0 0 0 0 0 0 0 0 0 0 0 0 0 0 0 0 0 4 4 4 4 4 4 4 7 4 6 4 4 6 4 4 C C C C 5 5 6 5 5 6 5 5 6 4 4 7 4 4 A A A A A A 9 A B A A A A A 9 A A A A A A A 9 A A A A A A A 9 A A A
0 0 0 0 0 1 0 0 0 0 0 0 0 0 0 1 0 0 0 0 0 0 0 0 0 1 0 0 0 0 0 0 0 5 5 5 5 5 5 7 5 5 5 5 5 6 5 5 C C C C 5 5 6 5 5 5 5 5 5 5 7 5 5 5 8 8 8 8 8 8 9 8 B 8 8 8 8 8 9 8 8 8 8 8 8 8 9 8 8 8 8 8 8 8 9 8 8 8
0 0 0 0 0 1 0 0 0 0 0 0 0 0 0 1 0 0 0 0 0 0 0 0 0 1 0 0 0 0 0 0 0 4 4 4 4 4 7 4 4 4 4 4 4 6 4 4 C C C C 5 5 6 5 5 5 5 4 4 7 4 4 4 4 8 8 8 8 8 8 8 8 8 8 8 8 8 8 8 8 8 8 8 8 8 8 8 8 8 8 8 8 8 8 8 8 8 8
0 0 0 0 0 1 0 0 0 0 0 0 0 0 0 1 0 0 0 0 0 0 0 0 0 1 0 0 0 0 0 0 0 4 4 4 4 7 4 4 4 4 4 4 4 4 4 4 C C C C 5 5 5 5 5 5 5 4 7 4 4 4 4 4 8 8 8 8 8 8 8 8 B 8 8 8 8 8 8 8 8 8 8 8 8 8 8 8 8 8 8 8 8 8 8 8 8 8
0 0 0 0 0 1 0 0 0 0 0 0 0 0 0 1 0 0 0 0 0 0 0 0 0 1 0 0 0 0 0 0 0 4 4 4 7 4 4 4 4 4 4 4 4 4 4 4 C C C C 4 4 5 5 5 4 4 7 4 4 4 4 4 4 8 8 8 8 8 8 8 8 B 8 8 8 8 8 8 8 8 8 8 8 8 8 8 8 8 8 8 8 8 8 8 8 8 8
0 2 2 2 0 2 2 2 0 2 2 2 0 2 2 2 0 2 2 2 0 2 2 2 0 2 2 2 0 2 2 2 0 4 4 7 4 4 4 4 4 4 4 4 4 4 4 4 C C C C 4 4 4 4 4 4 7 4 4 4 4 4 4 4 8 8 8 8 8 8 9 8 B 8 8 8 8 8 9 8 8 8 8 8 8 8 9 8 8 8 8 8 8 8 9 8 8 8
0 0 0 0 0 0 0 0 0 0 0 0 0 0 0 0 0 0 0 0 0 0 0 0 0 0 0 0 0 0 0 0 0 4 7 4 4 4 4 4 4 4 4 4 4 4 4 4 C C C C 4 4 4 4 4 7 4 4 4 4 4 4 4 4 8 8 8 8 8 8 9 8 B 8 8 8 8 8 9 8 8 8 8 8 8 8 9 8 8 8 8 8 8 8 9 8 8 8
0 0 0 0 0 1 0 0 0 0 0 0 0 0 0 1 0 0 0 0 0 0 0 0 0 1 0 0 0 0 0 0 0 7 4 5 5 4 4 4 5 5 4 4 4 5 5 4 C C C C 4 4 4 5 7 4 4 4 5 5 4 4 4 5 8 8 8 8 8 8 8 8 B 8 8 8 8 8 8 8 8 8 8 8 8 8 8 8 8 8 8 8 8 8 8 8 8 8
3 0 0 0 0 1 0 3 0 0 0 0 0 0 3 1 0 0 0 0 0 3 0 0 0 1 0 0 3 0 0 0 0 4 4 4 4 4 4 4 4 4 4 4 4 4 4 4 C C C C 4 4 4 7 4 4 4 4 4 4 4 4 4 4 A A A A A A A A B A A A A A A A A A A A A A A A A A A A A A A A A A
0 0 0 0 0 1 0 0 0 0 0 0 0 0 0 1 0 0 0 0 0 0 0 0 0 1 0 0 0 0 0 0 0 4 4 4 4 4 4 4 4 4 4 4 4 4 4 4 C C C C 4 4 7 4 4 4 4 4 4 4 4 4 4 4 A A A A A A A A A A A A A A A A A A A A A A A A A A A A A A A A A A
0 0 0 0 0 1 0 0 0 0 0 0 0 0 0 1 0 0 0 0 0 0 0 0 0 1 0 0 0 0 0 0 0 4 4 4 4 4 4 4 4 4 4 4 4 4 4 4 C C C C 4 7 4 4 4 4 4 4 4 4 4 4 4 4 8 8 8 8 8 8 9 8 B 8 8 8 8 8 9 8 8 8 8 8 8 8 9 8 8 8 8 8 8 8 9 8 8 8
0 0 0 0 0 0 0 0 0 0 0 0 0 0 0 0 0 0 0 0 0 0 0 0 0 0 0 0 0 0 0 0 0 4 4 4 4 4 4 4 4 4 4 4 4 4 4 4 C C C C 7 4 4 4 4 4 4 4 4 4 4 4 4 4 8 8 8 8 8 8 9 8 B 8 8 8 8 8 9 8 8 8 8 8 8 8 9 8 8 8 8 8 8 8 9 8 8 8
0 0 0 0 0 0 0 0 0 0 0 0 0 0 0 0 0 0 0 0 0 0 0 0 0 0 0 0 0 0 0 0 0 4 4 4 4 4 4 4 4 4 4 4 4 4 4 4 C C C C 4 4 4 4 4 4 4 4 4 4 4 4 4 4 8 8 8 8 8 8 8 8 B 8 8 8 8 8 8 8 8 8 8 8 8 8 8 8 8 8 8 8 8 8 8 8 8 8
0 0 0 0 0 1 0 0 0 0 0 0 0 0 0 1 0 0 0 0 0 0 0 0 0 1 0 0 0 0 0 0 0 5 5 5 5 5 5 5 5 5 5 5 5 5 5 5 C C C C 5 5 5 5 5 5 5 5 5 5 5 5 5 5 8 8 8 8 8 8 8 8 B 8 8 8 8 8 8 8 8 8 8 8 8 8 8 8 8 8 8 8 8 8 8 8 8 8
0 0 0 0 0 1 0 0 0 0 0 0 0 0 0 1 0 0 0 0 0 0 0 0 0 1 0 0 0 0 0 0 0 4 4 4 4 4 4 4 4 4 4 4 4 4 4 4 C C C C 4 4 4 4 4 4 4 4 4 4 4 4 4 4 8 8 8 8 8 8 8 8 B 8 8 8 8 8 8 8 8 8 8 8 8 8 8 8 8 8 8 8 8 8 8 8 8 8
0 2 2 2 0 1 2 2 0 2 2 2 0 2 2 1 0 2 2 2 0 2 2 2 0 1 2 2 0 2 2 2 0 4 4 4 4 4 4 4 4 4 4 4 4 4 4 4 C C C C 4 4 4 4 4 4 4 4 4 4 4 4 4 4 8 8 8 8 8 8 9 8 B 8 8 8 8 8 9 8 8 8 8 8 8 8 9 8 8 8 8 8 8 8 9 8 8 8
0 0 0 0 0 1 0 0 0 0 0 0 0 0 0 1 0 0 0 0 0 0 0 0 0 1 0 0 0 0 0 0 0 4 4 4 4 4 4 4 4 4 4 4 4 4 4 7 C C C C 4 4 4 4 4 4 4 4 4 4 4 4 4 4 8 8 8 8 8 8 9 8 8 8 8 8 8 8 9 8 8 8 8 8 8 8 9 8 8 8 8 8 8 8 9 8 8 8
0 0 0 0 0 0 0 0 0 0 0 0 0 0 0 0 0 0 0 0 0 0 0 0 0 0 0 0 0 0 0 0 0 4 4 4 4 4 4 4 4 4 4 4 4 4 7 4 C C C C 4 4 4 4 4 4 4 4 4 4 4 4 4 4 A A A A A A A A B A A A A A A A A A A A A A A A A A A A A A A A A A
0 0 0 0 0 0 0 0 0 0 0 0 0 0 0 0 0 0 0 0 0 0 0 0 0 0 0 0 0 0 0 0 0 4 4 4 4 4 4 4 4 4 4 4 4 7 4 4 C C C C 4 4 4 4 4 4 4 4 4 4 4 4 4 4 A A A A A A A A B A A A A A A A A A A A A A A A A A A A A A A A A A
0 0 0 0 0 1 0 0 0 0 0 0 0 0 0 1 0 0 0 0 0 0 0 0 0 1 0 0 0 0 0 0 0 4 4 4 4 4 4 4 4 4 4 4 7 4 4 4 C C C C 4 4 4 4 4 4 4 4 4 4 4 4 4 4 8 8 8 8 8 8 8 8 B 8 8 8 8 8 8 8 8 8 8 8 8 8 8 8 8 8 8 8 8 8 8 8 8 8
0 0 0 0 0 1 0 0 0 0 0 0 0 0 0 1 0 0 0 0 0 0 0 0 0 1 0 0 0 0 0 0 0 4 4 4 4 4 4 4 4 4 4 7 4 4 4 4 C C C C 4 4 4 4 4 4 4 4 4 4 4 4 4 4 8 8 8 8 8 8 9 8 B 8 8 8 8 8 9 8 8 8 8 8 8 8 9 8 8 8 8 8 8 8 9 8 8 8
3 0 0 0 0 1 0 3 0 0 0 0 0 0 3 1 0 0 0 0 0 3 0 0 0 1 0 0 3 0 0 0 0 4 4 4 4 4 4 4 4 4 7 4 4 4 4 4 C C C C 4 4 4 4 4 4 4 4 4 4 4 4 4 7 8 8 8 8 8 8 9 8 B 8 8 8 8 8 9 8 8 8 8 8 8 8 9 8 8 8 8 8 8 8 9 8 8 8
0 0 0 0 0 1 0 0 0 0 0 0 0 0 0 1 0 0 0 0 0 0 0 0 0 1 0 0 0 0 0 0 0 4 4 5 5 4 4 4 5 7 4 4 4 5 5 4 C C C C 4 4 4 5 5 4 4 4 5 5 4 4 7 5 8 8 8 8 8 8 8 8 B 8 8 8 8 8 8 8 8 8 8 8 8 8 8 8 8 8 8 8 8 8 8 8 8 8
0 0 0 0 0 0 0 0 0 0 0 0 0 0 0 0 0 0 0 0 0 0 0 0 0 0 0 0 0 0 0 0 0 4 4 4 4 4 4 4 7 4 4 4 4 4 4 4 C C C C 4 4 4 4 4 4 4 4 4 4 4 7 4 4 8 8 8 8 8 8 8 8 8 8 8 8 8 8 8 8 8 8 8 8 8 8 8 8 8 8 8 8 8 8 8 8 8 8
0 0 0 0 0 0 0 0 0 0 0 0 0 0 0 0 0 0 0 0 0 0 0 0 0 0 0 0 0 0 0 0 0 4 4 4 4 4 4 7 4 4 4 4 4 4 4 4 C C C C 4 4 4 4 4 4 4 4 4 4 7 4 4 4 8 8 8 8 8 8 8 8 B 8 8 8 8 8 8 8 8 8 8 8 8 8 8 8 8 8 8 8 8 8 8 8 8 8
R 11 20 1 1
R 12 60 1 1
R 20 80 1 1
R 26 35 1 1
R 28 55 1 1
R 40 25 2 1
R 42 65 2 1
R 52 30 2 1
R 59 80 2 1
R 60 50 2 1
R 73 20 3 1
R 78 45 3 1
R 82 70 3 1
R 89 35 3 1
R 92 85 3 1
