100 100
0 0 0 0 0 0 0 0 0 0 0 0 0 0 0 0 0 0 0 0 0 0 0 0 0 0 0 0 0 0 0 0 0 8 8 8 8 8 8 8 8 8 8 8 8 8 8 8 8 8 8 8 8 8 8 8 8 8 8 8 8 8 8 8 8 8 5 5 5 5 E 5 5 5 5 5 5 E 5 5 5 5 5 5 E 5 5 5 5 5 5 E 5 5 5 5 5 5 E 5
0 0 0 0 0 0 0 0 0 0 0 0 0 0 0 0 0 0 0 0 0 0 0 0 0 0 0 0 0 0 0 0 0 8 8 8 8 8 8 8 8 8 8 8 8 8 8 8 8 8 8 8 8 8 8 8 8 8 8 8 8 8 8 8 8 8 5 D D E D D D D D D E 5 D D D D D E D D D D 5 D E D D D D D D E D 5
0 0 0 0 0 0 0 0 0 0 0 0 0 0 0 0 0 0 0 0 0 0 0 0 0 0 0 0 0 0 0 0 0 8 8 8 8 8 8 8 8 8 8 8 8 8 8 8 8 8 8 8 8 8 8 8 8 8 8 8 8 8 8 8 8 8 5 D E D D D D D D E D 5 D D D D E D D D D D 5 E D D D D D D E D D 5
0 0 0 0 0 0 0 0 0 0 0 0 0 0 0 0 0 0 0 0 0 0 0 0 0 0 0 0 0 0 0 0 0 8 8 8 8 8 8 8 8 8 8 8 8 8 8 8 8 8 8 8 8 8 8 8 8 8 8 8 8 8 8 8 8 8 5 E D D D D D D E D D 5 D D D E D D D D D D E D D D D D D E D D D 5
0 0 0 0 0 0 0 0 0 0 0 0 0 0 0 0 0 0 0 0 0 0 0 0 0 0 0 0 0 0 0 0 0 8 8 8 8 8 8 8 8 8 8 8 8 8 8 8 8 8 8 8 8 8 8 8 8 8 8 8 8 8 8 8 8 8 E D D D D D D E D D D 5 D D E D D D D D D E 5 D D D D D E D D D D 5
0 0 0 0 0 3 0 0 0 0 0 0 0 0 0 0 0 0 0 0 0 0 0 0 0 0 0 0 0 0 0 0 0 8 8 8 8 8 8 8 8 8 8 8 8 8 8 8 8 8 8 8 8 8 8 8 8 8 8 8 8 8 8 8 8 8 5 D D D D D E D D D D 5 D E D D D D D D E D 5 D D D D E D D D D D 5
0 0 0 0 0 3 0 0 0 0 0 0 0 0 0 0 0 0 0 0 0 0 0 0 0 0 0 0 0 0 0 0 0 8 8 8 8 8 8 8 8 8 8 8 8 8 8 8 8 8 8 8 8 8 8 8 8 8 8 8 8 8 8 8 8 8 5 D D D D E D D D D D 5 E D D D D D D E D D 5 D D D E D D D D D D E
0 0 0 0 0 3 0 0 0 0 0 0 0 0 0 0 0 0 0 0 0 0 0 0 0 0 0 0 0 0 0 0 0 8 8 8 8 8 8 8 8 8 8 8 8 8 8 8 8 8 8 8 8 8 8 8 8 8 8 8 8 8 8 8 8 8 5 D D D E D D D D D D E D D D D D D E D D D 5 D D E D D D D D D E 5
0 0 0 0 0 3 0 0 0 0 0 0 0 0 0 0 0 0 0 0 0 0 0 0 0 0 0 0 0 0 0 0 0 8 8 8 8 8 8 8 8 8 8 8 8 8 8 8 8 8 8 8 8 8 8 8 8 8 8 8 8 8 8 8 8 8 5 D D E D D D D D D E 5 D D D D D E D D D D 5 D E D D D D D D E D 5
0 0 6 6 6 3 0 0 0 0 0 0 0 0 0 0 0 0 0 0 0 0 0 0 0 0 0 0 0 0 0 0 0 8 8 8 8 8 8 8 8 8 8 8 8 8 8 8 8 8 8 8 8 8 8 8 8 8 8 8 8 8 8 8 8 8 5 D E D D D D D D E D 5 D D D D E D D D D D 5 E D D D D D D E D D 5
0 0 6 4 6 3 0 0 0 0 0 0 0 0 0 0 0 0 0 0 0 0 0 0 0 0 0 0 0 0 0 0 0 8 8 8 8 8 8 8 8 8 8 8 8 8 8 8 8 8 8 8 8 8 8 8 8 8 8 8 8 8 8 8 8 8 5 E D D D D D D E D D 5 D D D E D D D A A A A A A A A A A A A A D 5
0 0 6 6 4 3 0 0 0 0 0 0 0 0 0 0 0 0 0 0 0 0 0 0 0 0 0 0 0 0 0 0 0 8 8 8 8 8 8 8 8 8 8 8 8 8 8 8 8 8 8 8 8 8 8 8 8 8 8 8 8 8 8 8 8 8 E 5 5 5 5 5 5 E 5 5 5 5 5 5 E 5 5 5 5 A A A A A A A A A A A A A 5 5
0 0 0 6 4 3 6 0 0 0 0 0 A A A A A A A A 0 0 0 0 0 0 0 0 0 0 0 0 0 8 8 8 8 8 8 8 8 8 8 8 8 8 8 8 8 8 8 8 8 8 8 8 8 8 8 8 8 8 8 8 8 8 5 D D D D D E D D D D 5 D E D D D D D A A 3 3 3 3 3 3 3 3 3 A A D 5
0 0 0 6 6 3 6 6 0 0 0 0 A 3 3 3 3 3 3 A 0 0 0 0 0 0 0 0 0 0 0 0 0 8 8 8 8 8 8 8 8 8 8 8 8 8 8 8 8 8 8 8 8 8 8 8 8 8 8 8 8 8 8 8 8 8 5 D D D D E D D D D D 5 E D D D D D D A A 3 3 3 3 3 3 3 3 3 A A D E
0 0 0 0 6 3 4 6 0 0 0 0 A 3 3 3 3 3 3 A 0 0 0 0 0 0 0 0 0 0 0 0 0 8 8 8 8 8 8 8 8 8 8 8 8 8 8 8 8 8 8 8 8 8 8 8 8 8 8 8 8 8 8 8 8 8 5 D D D E D D D D D D E D D D D D D E A A 3 3 3 3 3 3 3 3 3 A A E 5
0 0 0 0 0 3 4 6 6 0 0 0 A 3 3 3 3 3 3 A 0 0 0 0 0 3 0 0 0 0 0 0 0 8 8 8 8 8 8 8 8 8 8 8 8 8 8 8 8 8 8 8 8 8 8 8 8 8 8 8 8 8 8 8 8 8 5 D D E D D D D D D E 5 D D 3 D D E D A A 3 3 3 3 3 3 3 3 3 A A D 5
0 0 0 0 0 3 6 4 6 6 0 0 A 3 3 3 3 3 3 A 0 0 0 0 0 3 0 0 0 0 0 0 0 8 8 8 8 8 8 8 8 8 8 8 8 8 8 8 8 8 8 8 8 8 8 8 8 8 8 8 8 8 8 8 8 8 5 D E D D D D D D E D 5 D D 3 D E D D A A 3 3 3 3 3 3 3 3 3 A A D 5
0 0 0 0 0 3 6 6 4 6 6 0 A 3 3 3 3 3 3 A 0 0 0 0 0 3 0 0 0 0 0 0 0 8 8 8 8 8 8 8 8 8 8 8 8 8 8 8 8 8 8 8 8 8 8 8 8 8 8 8 8 8 8 8 8 8 5 E D D D D D D E D D 5 D D 3 E D D D A A 3 3 3 3 3 3 3 3 3 A A D 5
0 0 0 0 0 3 0 6 6 4 6 0 A A A 3 A A A A 0 0 0 0 0 3 0 0 0 0 0 0 0 8 8 8 8 8 A A A A A A 8 8 8 8 8 8 8 8 8 8 8 8 8 8 8 8 8 8 8 8 8 8 E D D D D D D E D D D 5 D D 3 D D D D A A 3 3 3 3 3 3 3 3 3 A A D 5
0 0 0 0 0 3 0 0 6 4 6 6 0 0 0 3 0 0 0 0 0 0 0 0 0 3 0 0 0 0 0 0 0 8 8 8 8 8 A 3 3 3 3 A 8 8 8 8 8 8 8 8 8 8 8 8 8 8 8 8 8 8 8 8 8 8 5 D D D D D E D D D D 5 D E 3 D D D D A A 3 3 3 3 3 3 3 3 3 A A D 5
0 0 0 0 0 3 0 0 6 6 4 6 0 0 3 3 3 3 0 0 0 0 0 0 A 3 3 3 3 3 3 3 3 3 A 8 8 8 A 3 3 3 3 A 8 8 8 8 8 8 8 8 8 8 8 8 8 8 8 8 8 8 8 8 8 8 5 D D D D E D D D D D 5 E D 3 D D D D A A 3 E E E E E E E 3 A A D E
0 0 0 0 0 3 0 0 5 6 4 6 0 0 3 3 3 3 0 0 0 0 0 0 3 3 3 3 3 3 3 3 3 3 3 8 8 8 A 3 3 3 3 A 8 8 8 8 8 8 8 8 8 8 8 8 8 8 8 8 8 8 8 8 8 8 5 D D D E D D D D D D E D D 3 D D D E A A 3 F F F F F F F 3 A A E 5
0 0 0 0 0 3 5 5 5 4 5 6 0 0 3 3 3 3 0 0 0 0 0 0 3 3 3 3 3 3 3 3 3 3 3 8 8 8 A A 3 A A A 8 8 8 8 8 8 8 8 8 8 8 8 8 8 8 8 8 8 8 8 8 8 5 5 5 E 5 5 5 5 5 5 E 5 5 5 3 5 5 E 5 A A 3 E E E E E E E 3 A A 5 5
0 0 0 0 0 3 5 5 5 4 5 5 0 0 3 3 3 3 0 0 0 0 0 0 3 3 3 3 3 3 3 3 3 3 3 8 8 8 8 8 3 8 8 8 8 8 8 8 8 8 8 8 8 8 8 8 8 8 8 8 8 8 8 8 8 8 5 D E D D D D D D E D 5 D D 3 D E D D A A 3 3 3 3 3 3 3 3 3 A A D 5
0 0 0 0 0 3 5 5 5 4 5 5 0 0 0 0 0 0 0 0 0 0 0 0 3 3 3 3 3 3 3 3 3 3 3 8 8 8 8 8 8 8 8 8 8 8 8 8 8 8 8 8 8 8 8 8 8 8 8 8 8 8 8 8 8 8 5 E D D D D D D E D D 5 D D 3 E D D D A A 3 E E E E E E E 3 A A D 5
0 0 0 0 5 3 5 5 5 4 5 5 5 0 0 0 0 0 0 0 0 0 0 0 3 3 3 3 3 3 3 3 3 3 3 3 3 3 3 3 3 3 3 3 3 3 3 3 3 3 3 3 3 3 3 3 3 3 3 3 3 3 3 3 3 3 3 3 3 3 3 3 3 3 3 3 3 3 3 3 3 D D D D A A 3 F F F F F F F 3 A A D 5
0 0 0 0 0 3 5 5 4 5 5 5 0 0 0 0 0 0 0 0 0 0 0 0 3 3 3 3 3 3 3 3 3 3 3 8 8 8 8 8 8 8 8 8 8 8 8 8 8 3 8 8 8 8 8 8 8 8 8 8 8 8 8 8 8 8 5 D D D D D E D D D D 5 D E D D D D D A A 3 E E E E E E E 3 A A D 5
0 0 0 0 0 3 5 5 4 5 5 5 0 0 0 0 0 0 0 0 0 0 0 0 3 3 3 3 3 3 3 3 3 3 3 8 8 8 8 8 8 8 8 8 8 8 8 8 8 3 8 8 8 8 8 8 8 8 8 8 8 8 8 8 8 8 5 D D D D E D D D D D 5 E D D D D D D A A 3 3 3 3 3 3 3 3 3 A A D E
0 0 0 0 0 3 5 5 4 5 5 0 0 0 0 0 0 0 0 0 0 0 0 0 3 3 3 3 3 3 3 3 3 3 3 8 8 8 8 8 8 8 8 8 8 8 8 8 8 3 8 8 8 8 8 8 8 8 8 8 8 8 8 8 8 8 5 D D D E D D D D D D E D D D D D D E A A 3 3 3 3 3 3 3 3 3 A A E 5
0 0 0 0 0 3 6 6 4 6 0 0 0 0 0 0 0 0 0 0 0 0 0 0 3 3 3 3 3 3 3 3 3 3 3 8 8 8 8 8 8 8 8 8 8 8 8 8 8 3 8 8 8 8 8 8 8 8 8 8 8 8 8 8 8 8 5 D D E D D D D D D E 5 D D D D D E D A A 3 3 3 3 3 3 3 3 3 A A D 5
0 0 0 0 0 3 6 4 6 6 0 0 0 0 0 0 0 0 0 0 0 0 0 0 3 3 3 3 3 3 3 3 3 3 3 3 8 8 8 8 8 8 8 8 8 8 8 8 8 3 8 8 8 8 8 8 8 8 8 8 8 8 8 8 8 8 5 D E D F F F F F F F F F F F F F F F A A 3 3 3 3 3 3 3 3 3 A A D 5
0 0 0 0 0 3 6 4 6 0 0 0 0 0 0 0 0 0 0 0 0 0 0 0 3 3 3 3 3 3 3 3 3 3 3 8 8 8 8 8 8 8 8 8 8 8 8 8 8 3 8 8 8 8 8 8 8 8 8 8 8 8 8 8 8 8 5 E D D E E E E E E E E E E E E E E E A A A A A A A A A A A A A D 5
0 0 0 0 0 3 6 4 6 0 0 0 0 0 0 0 0 0 0 0 0 0 0 0 3 3 3 3 3 3 3 3 3 3 A 8 8 8 8 8 8 8 8 8 8 8 8 8 8 3 8 8 8 8 8 8 8 8 A A A A A A 8 8 E D D D E E E E E E E E E E E E E E E A A A A A A A A A A A A A D 5
0 0 0 0 0 3 6 4 6 0 0 0 0 0 0 0 0 0 0 0 0 0 0 0 3 3 0 0 0 0 0 0 0 8 8 8 8 8 8 8 8 8 8 8 8 8 8 8 8 3 8 8 8 8 8 8 8 8 A 3 3 3 3 A 8 8 5 5 5 5 F F F F F F F F F F F F F F F F F F F F F F F F F 5 5 5 5 5
0 0 0 0 0 3 4 6 6 0 0 0 0 0 0 0 0 0 0 0 0 0 0 0 3 3 0 0 0 0 0 0 0 8 8 8 8 8 8 8 8 8 8 8 8 9 8 8 8 3 8 8 8 8 8 8 8 8 A 3 3 3 3 A 8 8 5 D D D D E D D D D D 5 E D D D D D D E D D 5 D D D E D D D D D D E
0 0 0 0 0 3 3 3 3 3 3 3 3 3 3 3 3 3 3 3 3 3 3 3 3 3 0 0 0 0 0 0 0 8 8 8 8 8 8 8 8 8 9 9 9 9 9 9 9 3 8 8 8 8 8 8 8 8 A 3 3 3 3 A 8 8 5 D D D E D D D D D D E D D D D D D E D D D 5 D D E D D D D D D E 5
0 0 0 0 0 3 4 6 6 0 0 0 0 0 0 0 0 0 0 0 0 0 0 0 0 0 0 0 0 0 0 0 0 8 8 8 8 8 8 8 8 9 9 9 9 9 9 9 9 9 8 8 8 8 8 8 8 8 A A 3 A A A 8 8 5 D D E D D D D D D E 5 D D D D D E D D D D 5 D E D D D D D D E A 5
0 0 0 0 0 3 6 4 6 0 0 0 0 0 0 0 0 0 0 0 0 0 0 0 0 5 0 0 0 0 0 0 0 8 8 8 8 8 8 8 9 9 9 9 9 9 9 9 9 9 9 8 8 8 8 8 8 8 8 8 3 8 8 8 8 8 5 D E D D D D D D E D 5 D D D D E D D D D D 5 E D D D D D D E D A 5
0 0 0 0 0 3 6 4 6 6 0 0 0 0 0 0 0 0 0 0 0 0 0 5 5 5 5 5 0 0 0 0 0 8 8 8 8 8 8 8 9 9 9 9 9 9 9 9 9 9 9 8 8 8 8 8 8 8 8 8 8 8 8 8 8 8 5 E D D D D D D E D D 5 D D D E D D D D D D E D D D D D D E D D A 5
0 0 0 0 0 3 6 6 4 6 0 0 0 0 0 0 0 0 0 0 0 0 0 5 5 5 5 5 0 0 0 0 0 8 8 8 8 8 8 8 9 9 9 9 9 9 9 9 9 9 9 8 8 8 8 8 8 8 8 8 8 8 8 8 8 8 E D D D D D D E D D D 5 D D E D D D D D D E 5 D D D D D E D D D A 5
0 0 0 0 0 3 0 6 4 6 B B B B B B B B 0 0 0 0 5 5 5 5 5 5 5 0 0 0 0 8 8 8 8 8 8 9 9 9 9 9 9 9 9 9 9 9 9 9 8 8 8 8 8 8 8 8 8 8 8 8 8 8 5 D D D D D E D D D D 5 D E D D D D D D E D 5 D F D D E D D D D A 5
0 0 0 0 0 3 0 6 4 6 B B B B B B B B 0 0 0 0 0 5 5 5 5 5 0 0 0 0 0 8 8 8 8 8 8 8 9 9 9 9 9 9 9 9 9 9 9 8 8 8 8 8 8 8 8 8 8 8 8 8 8 8 5 D D D D E D D D D D 5 E D D D D D D E D D 5 D F D E D D D D D D E
0 0 0 0 0 3 0 6 6 4 A 3 3 3 3 3 3 A 0 0 0 0 0 5 5 5 5 5 0 0 0 0 0 8 8 8 8 5 8 8 9 9 9 9 9 9 9 9 9 9 9 8 8 8 8 8 8 8 8 8 8 8 8 8 8 8 5 D D D E D D D D D D E D D D D D D E D D D 5 D F E D D D D D D E 5
0 0 0 0 0 3 0 0 6 4 A 3 3 5 3 3 3 A 0 0 0 0 0 0 0 5 0 0 0 0 0 0 0 8 8 5 5 5 5 5 9 9 9 9 9 9 9 9 9 9 9 8 8 8 8 8 8 8 8 8 8 8 8 8 8 8 5 D D E D D D D D D E 5 D D D D D E D D D D 5 D F D D D D D D E D 5
0 0 0 0 0 3 0 0 6 6 A 3 3 3 3 3 3 A 0 0 0 0 0 0 0 0 0 0 0 0 0 0 0 8 8 5 5 5 5 5 8 9 9 9 9 9 9 9 9 9 8 8 8 8 8 8 8 8 8 8 8 8 8 8 8 8 5 5 E 5 5 5 5 5 5 E 5 5 5 5 5 5 E 5 5 5 5 5 5 E F 5 5 5 5 5 E 5 5 5
0 0 0 0 0 3 0 0 0 6 A 5 B B B 5 B A 0 0 0 0 0 0 0 0 0 0 0 0 0 0 0 8 5 5 5 5 5 5 5 8 9 9 9 9 9 9 9 3 8 8 8 8 8 8 8 8 8 8 8 8 8 8 8 8 5 E D D D D D D E D D 5 D D D E D D D D D D E D F D D D D E D D D 5
0 0 0 0 0 3 0 0 0 6 A B 3 3 3 B B A 0 0 0 0 0 0 0 0 0 0 0 0 0 0 0 8 8 5 5 5 5 5 8 8 8 8 8 9 8 8 8 3 8 8 8 8 8 8 8 8 8 8 8 8 8 8 8 8 E D D D D D D E D D D 5 D D E D D D D D D E 5 D F D D D E D D D D 5
0 0 0 0 0 3 0 0 0 6 6 4 6 3 0 0 0 0 0 0 0 0 0 0 0 0 0 0 0 0 0 0 0 8 8 5 5 5 5 5 8 8 8 8 8 8 8 8 8 3 8 8 8 8 8 8 8 8 8 8 8 8 8 8 8 8 5 D D D D D E D D D D 5 D E D D D D D D E D 5 D F D D E D D D D D 5
0 0 0 0 0 3 0 0 0 0 6 4 6 3 0 0 0 0 0 0 0 0 0 0 0 0 0 0 0 0 0 0 0 8 8 8 8 5 8 8 8 8 8 8 8 8 8 8 8 3 8 8 8 8 8 8 8 8 8 8 8 8 8 8 8 8 5 D D D D E D D D D D 5 E D D D D D D E D D 5 D F D A D D D D D D E
0 0 0 0 0 3 0 0 0 0 6 6 4 3 0 0 0 0 0 0 0 0 0 0 0 0 0 0 0 0 0 0 0 8 8 8 8 8 8 8 8 8 8 8 8 8 8 8 8 3 8 8 8 8 8 8 8 8 8 8 8 8 8 8 8 8 5 D D D E D D D D D D E D D D D D D E D D D 5 D F E A D D D D D E 5
0 0 0 0 0 3 0 0 0 0 0 6 4 3 0 0 0 0 0 0 0 0 0 0 0 0 0 0 0 0 0 0 0 3 3 3 3 3 3 3 3 3 3 3 3 3 3 3 3 3 3 3 3 3 3 3 3 3 3 3 3 3 3 3 3 3 3 3 3 3 3 3 3 3 3 3 3 3 3 3 3 3 3 3 3 3 3 3 5 3 F 3 A 3 3 3 3 3 3 5
0 0 0 0 0 3 0 0 0 0 0 6 4 6 0 0 0 0 0 0 0 0 0 0 0 0 0 0 0 0 0 0 0 8 8 8 8 8 8 8 8 8 8 8 8 8 8 8 8 3 8 8 8 8 8 8 8 8 8 8 5 8 8 8 8 8 5 D E D D D D D D E D 5 D D D D 3 D D D D D 5 E F D A D D D E D D 5
0 0 0 0 0 3 0 0 0 0 6 6 4 6 0 0 0 0 0 0 0 0 0 0 0 0 0 0 0 0 0 0 0 8 8 8 8 8 8 8 8 8 8 8 8 8 8 8 8 3 8 8 8 8 8 8 8 8 5 5 5 5 5 8 8 8 5 E D D D D D D E D D 5 D D D E 3 D D D D D E D F D A D D E D D D 5
0 0 0 0 0 3 0 0 0 0 6 4 6 6 0 0 0 0 0 0 0 0 0 0 0 0 0 0 0 0 0 0 0 8 8 8 8 8 8 8 8 8 8 8 8 8 8 8 8 3 8 8 8 8 8 8 8 5 5 5 5 5 5 5 8 8 E D D D D D D E D D D 5 D D E D 3 D D D D E 5 D F D A D E D D D D 5
0 0 0 0 0 3 0 0 0 0 6 4 6 0 0 0 0 0 0 0 0 0 0 0 0 0 0 0 0 0 0 0 0 8 8 8 8 8 8 8 8 8 8 8 8 8 8 8 8 3 8 8 8 8 8 8 8 5 5 5 5 5 5 5 8 8 5 D D D D D E D D D D 5 D E D D 3 D D D E D 5 D F D A E D D D D D 5
0 0 0 0 0 3 0 0 0 0 6 4 6 0 0 0 0 0 5 0 0 0 0 0 0 0 0 0 0 0 0 0 0 8 8 8 8 8 8 8 8 8 8 8 8 8 8 8 8 3 8 8 8 8 8 8 5 5 5 5 5 5 5 5 5 8 5 5 5 5 5 E 5 5 5 5 5 5 E 5 5 5 3 5 5 E 5 5 5 5 F 5 A 5 5 5 5 5 5 E
0 0 0 0 0 3 0 0 0 0 6 4 6 0 0 5 5 5 5 5 5 5 0 0 0 0 0 0 0 0 0 0 0 8 8 8 8 8 8 8 8 8 8 8 8 8 8 8 8 3 8 8 8 8 8 8 8 5 5 5 5 5 5 5 8 8 5 D D D E D D D D D D E D D D D 3 D E D D D 5 D F E D D D D D D E 5
0 0 0 0 0 3 0 0 0 6 6 4 6 0 5 5 5 5 5 5 5 5 5 0 0 0 0 0 0 0 0 0 0 8 8 8 8 8 8 8 8 8 8 8 8 8 8 8 8 3 8 8 8 8 8 8 8 5 5 5 5 5 5 5 8 8 5 D D E D D D D D D E 5 D D D D 3 E D D D D 5 D F D D D D D D E D 5
0 0 0 0 0 3 0 0 0 6 4 6 6 0 5 5 5 5 5 5 5 5 5 0 0 0 0 0 0 0 0 0 0 8 8 8 8 8 8 8 8 8 8 8 8 8 8 8 8 3 8 8 8 8 8 8 8 8 5 5 5 5 5 8 8 8 5 D E D D D D D D E D 5 D D D D 3 D D D D D 5 E F D D D D D E D D 5
0 0 0 0 0 3 0 0 0 6 4 6 0 0 5 5 5 5 5 5 5 5 5 0 0 0 0 0 0 0 0 0 0 8 8 8 8 8 8 8 8 8 8 8 8 8 8 8 8 3 8 8 8 8 8 8 8 8 8 8 5 8 8 8 8 8 5 E D D D D D D E D D 5 D D D E 3 D D D D D E D F D D D D E D D D 5
0 0 0 0 0 3 0 0 0 6 4 6 0 5 5 5 5 5 5 5 5 5 5 5 0 0 0 0 0 0 0 0 0 8 8 8 8 8 8 8 A A A A A A 8 8 8 3 8 8 8 8 8 8 8 8 8 8 8 8 8 8 8 8 E D D D D D F F F F F F F F F F F F F F F F F F F D D D E D D D D 5
0 0 0 0 0 3 0 0 0 6 4 6 0 0 5 5 5 5 5 5 5 5 5 0 0 0 0 0 0 0 0 0 0 8 8 8 8 8 8 8 A 3 3 3 3 A 8 8 8 3 8 8 8 8 8 8 8 8 8 8 8 8 8 8 8 8 5 D D D D D E E E E E E E E E E E E E E E E E E F D D E D D D D D 5
0 0 0 0 0 3 0 0 6 6 4 6 0 0 5 5 5 5 5 5 5 5 5 0 0 0 0 0 0 0 0 0 0 8 8 8 8 8 8 8 A 3 3 3 3 A 8 8 8 3 8 8 8 8 8 9 8 8 8 8 8 8 8 8 8 8 5 D D D D E E E E E E E E E E E E E E E E E E E F D E D D D D D D E
0 0 0 0 0 3 0 0 6 4 6 6 0 0 5 5 5 5 5 5 5 5 5 0 0 0 0 0 0 0 0 0 0 8 8 8 8 8 8 8 A 3 3 3 3 A 8 8 8 3 8 8 9 9 9 9 9 9 9 8 8 8 8 8 8 8 5 D D D E E C C C C C C C 3 C C C C C C C E F F F E D D D D D D E 5
0 0 0 0 0 3 0 0 6 4 6 0 0 0 0 5 5 5 5 5 5 5 0 0 0 0 0 0 0 0 0 0 0 8 8 8 8 8 8 8 A A 3 A A A 8 8 8 3 9 9 9 9 9 9 9 9 9 9 9 8 8 8 8 8 5 D D E D E C C C C C C C 3 C C C C C C C E 5 D F D D D D D D E D 5
0 0 0 0 0 3 0 0 6 4 6 0 0 0 0 0 0 0 5 0 0 0 0 0 0 0 0 0 0 0 0 0 0 8 8 8 8 8 8 8 8 8 3 8 8 8 8 8 8 9 9 9 9 9 9 9 9 9 9 9 9 9 8 8 8 8 5 D E D D E 3 3 3 3 3 3 3 3 3 3 3 3 3 3 3 E 5 E F D D D D D E D D 5
0 0 0 0 0 3 0 0 6 4 6 0 0 0 0 0 0 0 0 0 0 0 0 0 0 0 0 0 0 0 0 0 0 8 8 8 8 8 8 8 8 8 8 8 8 8 8 8 8 9 9 9 9 9 9 9 9 9 9 9 9 9 8 8 8 8 5 E 5 5 5 E C C C C C C C 3 C C C C C C C E E 5 F 5 5 5 5 E 5 5 5 5
0 0 0 0 0 3 0 6 6 4 6 0 0 0 0 0 0 0 0 0 0 0 0 0 0 0 0 0 0 0 0 0 0 8 8 8 8 8 8 8 8 8 8 8 8 8 8 8 9 9 9 9 9 9 9 9 9 9 9 9 9 9 9 8 8 8 E D D D D E C C C C C C C 3 C C C C C C C E 5 D F D D D E D D D D 5
0 0 0 0 0 3 0 6 4 6 6 0 0 0 0 0 0 0 0 0 0 0 0 0 0 0 0 0 0 0 0 0 0 8 8 8 8 8 8 8 8 8 8 8 8 8 8 8 9 9 9 9 9 9 9 9 9 9 9 9 9 9 9 8 8 8 5 D D D D E C C C C C C C 3 C C C C C C C E 5 D F D D E D D D D D 5
0 0 0 0 0 3 0 6 4 6 0 0 0 0 0 0 0 0 0 0 0 0 0 0 0 0 0 0 0 0 0 0 0 8 8 8 8 8 8 8 8 8 8 8 8 8 8 8 9 9 9 9 9 9 9 9 9 9 9 9 9 9 9 8 8 8 5 D D D D E E E E E E E E E E E E E E E E E 5 D F D E D D D D D D E
0 0 0 0 0 3 0 6 4 6 0 0 0 0 0 0 0 0 0 0 A A A A A A A A A 0 0 0 0 8 8 8 8 8 8 8 8 8 8 8 8 8 8 9 9 9 9 9 9 9 9 9 9 9 9 9 9 9 9 9 8 8 5 D D D E D D D D A D E D D D D 3 D E D D D 5 D F E D D D D D D E 5
0 0 0 0 0 3 0 6 4 6 6 0 0 0 0 0 0 0 0 0 A 3 3 3 3 3 3 3 A 0 0 0 0 8 8 8 8 8 8 8 8 8 8 8 8 8 8 8 9 9 9 9 9 9 9 9 9 9 9 9 9 9 9 8 8 8 5 D D E D D D D D D E 5 D D D D 3 E D D D D 5 D F D D D D D D E D 5
0 0 0 0 0 3 0 6 6 4 6 0 0 0 0 0 0 0 0 0 A 3 3 3 3 3 3 3 A 5 5 0 0 8 8 8 8 8 8 8 8 8 8 8 8 8 8 8 9 9 9 9 9 9 9 9 9 9 9 9 9 9 9 8 8 8 5 D E D D D D D D E D 5 D D D D 3 D D D D D 5 E F D D D D D E D D 5
0 0 0 0 0 3 0 0 6 4 6 6 0 0 0 0 0 0 0 0 A 3 3 3 3 3 3 3 A 5 5 5 0 8 8 8 8 8 8 8 8 8 8 8 8 8 8 8 9 9 9 9 9 9 9 9 9 9 9 9 9 9 9 8 8 8 5 E D D D D D D E D D 5 D D D E 3 D D D D D E D F D D D D E D D D 5
0 0 0 0 0 3 0 0 6 6 4 6 0 0 0 0 0 0 0 0 A 3 3 3 3 3 3 3 A 5 5 5 0 8 8 8 8 8 8 8 8 8 8 8 8 8 8 8 8 9 9 9 9 9 9 9 9 9 9 9 9 9 8 8 8 8 E D D D D D D E D D D 5 D D E D 3 D D D D E 5 D F D D D E D D D D 5
0 0 0 0 0 3 0 0 0 6 4 6 6 0 0 0 0 0 0 0 A A A A 3 A A A A 5 5 5 5 8 8 8 8 8 8 8 8 8 8 8 8 8 8 8 8 9 9 9 9 9 9 9 9 9 9 9 9 9 8 8 8 8 5 D D D D D E D D D D 5 D E D D 3 D D D E D 5 D F D D E D D D D D 5
0 0 0 0 0 3 0 0 0 6 6 4 6 0 0 0 0 0 0 0 0 0 0 0 3 5 5 5 5 5 5 5 0 8 8 8 8 8 8 8 8 8 8 8 8 8 8 8 8 3 9 9 9 9 9 9 9 9 9 9 9 8 8 8 8 8 5 D D D D E D D D D D 5 E D D D 3 D D E D D 5 D F D E D D D D D D E
0 0 0 0 0 3 0 0 0 0 6 4 6 6 0 0 0 0 0 0 0 0 0 0 0 5 5 5 5 5 5 5 0 8 8 8 8 8 8 8 8 8 8 8 8 8 8 8 8 3 8 8 9 9 9 9 9 9 9 8 8 8 8 8 8 8 5 5 5 5 E 5 5 5 5 5 5 E 5 5 5 5 3 5 E 5 5 5 5 5 F E 5 5 5 5 5 5 E 5
0 0 0 0 0 3 0 0 0 0 6 6 4 6 0 0 0 0 0 0 0 0 0 0 0 0 5 5 5 5 5 0 0 8 8 8 8 8 8 8 8 8 8 8 8 8 8 8 8 3 8 8 8 8 8 9 8 8 8 8 8 8 8 8 8 8 5 D D E D D D D D D E 5 D D D D 3 E D D D D 5 D F D D D D D D E D 5
0 0 0 0 0 3 0 0 0 0 0 6 4 6 6 0 0 0 0 0 0 0 0 0 0 0 0 0 5 0 0 0 0 8 8 8 8 8 8 8 8 8 8 8 8 8 8 8 8 3 8 8 8 8 8 8 8 8 8 8 8 8 8 8 8 8 5 D E D D D D D D E D 5 D D D D 3 D D D D D 5 E F D D D D D E D D 5
0 0 0 0 0 3 0 0 0 0 0 6 6 4 6 0 0 0 0 0 0 0 0 0 0 0 0 0 0 0 0 0 0 8 8 8 8 8 8 8 8 8 8 8 8 8 8 8 8 3 8 8 8 8 8 8 8 8 8 8 8 8 8 8 8 8 5 E D D D D D D E D D 5 D D D E 3 D D D D D E D D D D D D E D D D 5
0 0 0 0 0 3 0 0 0 0 0 0 6 4 6 6 0 0 0 0 0 0 0 0 0 0 0 0 0 0 0 0 0 8 8 8 8 8 8 8 8 8 8 8 8 8 8 8 8 8 8 8 8 8 8 8 8 8 8 8 8 8 8 8 8 8 E D D D D D D E D D D 5 D D E D 3 D D D D E 5 D D D D D E D D D D 5
0 0 0 0 0 3 0 0 0 0 0 0 6 6 4 6 0 0 0 0 0 0 0 0 0 0 0 0 0 0 0 0 0 8 8 8 8 8 8 8 8 8 8 8 8 8 8 8 8 8 8 8 8 8 8 8 8 8 8 8 8 8 8 8 8 8 5 D D D D D E D D D D 5 D E D D 3 D D D E D 5 D D D D E D D D D D 5
0 0 0 0 0 3 0 0 0 0 0 0 0 6 4 6 6 0 0 0 0 0 0 0 0 0 0 0 0 0 0 0 0 8 8 8 8 8 8 8 8 8 8 8 8 8 8 8 8 8 8 8 8 8 8 8 8 8 8 8 8 8 8 8 8 8 5 D D D D E D D D D D 5 E D D D 3 D D E D D 5 D D D E D D D D D D E
0 0 0 0 0 3 0 0 0 0 0 0 0 6 6 4 6 0 0 0 0 0 0 0 0 0 0 0 0 0 0 0 0 8 8 8 8 8 8 8 8 8 8 8 8 8 8 8 8 8 8 8 8 8 8 8 8 8 8 8 8 8 8 8 8 8 5 D D D E D D D D D D E D D D D 3 D E D D D 5 D D E D D D D D D E 5
0 0 0 0 0 3 0 0 0 0 0 0 0 0 6 4 6 0 0 0 0 0 0 0 0 0 0 0 0 0 0 0 0 8 8 8 8 8 8 8 8 8 8 8 8 8 8 8 8 8 5 8 8 8 8 8 8 8 8 8 8 8 8 8 8 8 5 D D E D D D D D D E 5 D D D D 3 3 3 3 3 3 3 3 3 3 3 3 3 3 3 3 3 3
0 0 0 0 0 3 0 0 0 0 0 0 0 0 6 6 6 0 0 0 0 0 0 0 0 0 0 0 0 0 0 0 0 8 8 8 8 8 8 8 8 8 8 8 8 8 8 5 5 5 5 5 5 5 8 8 8 8 8 8 8 8 8 8 8 8 5 D E D D D D D D E D 5 D D D D E D D D D D 5 E D D D D D D E D D 5
0 0 0 0 0 3 0 0 0 0 0 0 0 0 0 0 0 0 0 0 0 0 0 0 0 0 0 0 0 0 0 0 0 8 8 8 8 8 8 8 8 8 8 8 8 8 5 5 5 5 5 5 5 5 5 8 8 8 8 8 8 8 8 8 8 8 5 E D D D D D D E D D 5 D D D E D D D D D D E D D D D D D E D D D 5
0 0 0 0 0 3 0 0 0 0 0 0 0 0 0 0 0 0 0 0 0 0 0 0 0 0 0 0 0 0 0 0 0 8 8 8 8 8 8 8 8 8 8 8 8 8 5 5 5 5 5 5 5 5 5 8 8 8 8 8 8 8 8 8 8 8 E 5 5 5 5 5 5 E 5 5 5 5 5 5 E 5 5 5 5 5 5 E 5 5 5 5 5 5 E 5 5 5 5 5
0 0 0 0 0 3 0 0 0 0 0 0 0 0 0 0 0 0 0 0 0 0 0 0 0 0 0 0 0 0 0 0 0 8 8 8 8 8 8 8 8 8 8 8 8 8 5 5 5 5 5 5 5 5 5 8 8 8 8 8 8 8 8 8 8 8 5 D D D D D E D D D D 5 D E D D D D D D E D 5 D D D D E D D D D D 5
0 0 0 0 0 3 0 0 0 0 0 0 0 0 0 0 0 0 0 0 0 0 0 0 0 0 0 0 0 0 0 0 0 8 8 8 8 8 8 8 8 8 8 8 8 5 5 5 5 5 5 5 5 5 5 5 8 8 8 8 8 8 8 8 8 8 5 D D D D E D D D D D 5 E D D D D D D E D D 5 D D D E D D D D D D E
0 0 0 0 0 3 0 0 0 0 0 0 0 0 0 0 0 0 0 0 0 0 0 0 0 0 0 0 0 0 0 0 0 8 8 8 8 8 8 8 8 8 8 8 8 8 5 5 5 5 5 5 5 5 5 8 8 8 8 8 8 8 8 8 8 8 5 D D D E D D D D D D E D D D D D D E D D D 5 D D E D D D D D D E 5
0 0 0 0 0 3 0 0 0 0 0 0 0 0 0 0 0 0 0 0 0 0 0 0 0 0 0 0 0 0 0 0 0 8 8 8 8 8 8 8 8 8 8 8 8 8 5 5 5 5 5 5 5 5 5 8 8 8 8 8 8 8 8 8 8 8 5 D D E D D D D D D E 5 D D D D D E D D D D 5 D E D D D D D D E D 5
0 0 0 0 0 3 0 0 0 0 0 0 0 0 0 0 0 0 0 0 0 0 0 0 0 0 0 0 0 0 0 0 0 8 8 8 8 8 8 8 8 8 8 8 8 8 5 5 5 5 5 5 5 5 5 8 8 8 8 8 8 8 8 8 8 8 5 D E D D D D D D E D 5 D D D D E D D D D D 5 E D D D D D D E D D 5
0 0 0 0 0 3 0 0 0 0 0 0 0 0 0 0 0 0 0 0 0 0 0 0 0 0 0 0 0 0 0 0 0 8 8 8 8 8 8 8 8 8 8 8 8 8 8 5 5 5 5 5 5 5 8 8 8 8 8 8 8 8 8 8 8 8 5 E D D D D D D E D D 5 D D D E D D D D D D E D D D D D D E D D D 5
0 0 0 0 0 3 3 3 3 3 3 3 3 3 3 3 3 3 3 3 3 3 3 3 3 3 3 3 3 3 3 0 0 8 8 8 8 8 8 8 8 8 8 8 8 8 8 8 8 8 5 8 8 8 8 8 8 8 8 8 8 8 8 8 8 8 E D D D D D D E D D D 5 D D E D D D D D D E 5 D D D D D E D D D D 5
0 0 0 0 0 0 0 0 0 0 0 0 0 0 0 0 0 0 0 0 0 0 0 0 0 0 0 0 0 0 0 0 0 8 8 8 8 8 8 8 8 8 8 8 8 8 8 8 8 8 8 8 8 8 8 8 8 8 8 8 8 8 8 8 8 8 5 D D D D D E D D D D 5 D E D D D D D D E D 5 D D D D E D D D D D 5
0 0 0 0 0 0 0 0 0 0 0 0 0 0 0 0 0 0 0 0 0 0 0 0 0 0 0 0 0 0 0 0 0 8 8 8 8 8 8 8 8 8 8 8 8 8 8 8 8 8 8 8 8 8 8 8 8 8 8 8 8 8 8 8 8 8 5 D D D D E D D D D D 5 E D D D D D D E D D 5 D D D E D D D D D D E
0 0 0 0 0 0 0 0 0 0 0 0 0 0 0 0 0 0 0 0 0 0 0 0 0 0 0 0 0 0 0 0 0 8 8 8 8 8 8 8 8 8 8 8 8 8 8 8 8 8 8 8 8 8 8 8 8 8 8 8 8 8 8 8 8 8 5 D D D E D D D D D D E D D D D D D E D D D 5 D D E D D D D D D E 5
0 0 0 0 0 0 0 0 0 0 0 0 0 0 0 0 0 0 0 0 0 0 0 0 0 0 0 0 0 0 0 0 0 8 8 8 8 8 8 8 8 8 8 8 8 8 8 8 8 8 8 8 8 8 8 8 8 8 8 8 8 8 8 8 8 8 5 5 5 E 5 5 5 5 5 5 E 5 5 5 5 5 5 E 5 5 5 5 5 5 E 5 5 5 5 5 5 E 5 5

; Recursos
R 30 25 1 1
R 32 24 2 1
R 29 23 3 1
R 26 25 4 1
R 31 28 1 1
R 27 29 2 1
R 35 30 3 1
