100 100
1 2 0 0 3 0 0 1 2 0 0 3 0 0 1 2 0 1 2 0 0 3 0 0 1 2 0 0 3 0 0 1 2 0 1 2 0 0 3 0 0 1 2 0 0 3 0 4 4 4 4 6 5 7 4 4 4 6 5 7 4 4 4 4 6 5 4 4 4 4 6 5 7 4 4 4 6 5 7 4 4 4 4 6 5 4 4 4 4 6 5 7 4 4 4 6 5 7 4 4
2 0 1 2 0 0 3 0 0 1 2 0 0 3 0 0 1 2 0 1 2 0 0 3 0 0 1 2 0 0 3 0 0 1 2 0 1 2 0 0 3 0 0 1 2 0 0 6 5 7 4 4 4 4 6 5 4 4 4 4 6 5 7 4 4 4 6 5 7 4 4 4 4 6 5 4 4 4 4 6 5 7 4 4 4 6 5 7 4 4 4 4 6 5 4 4 4 4 6 5
0 1 2 0 1 2 0 0 3 0 0 1 2 0 0 3 0 0 1 2 0 1 2 0 0 3 0 0 1 2 0 0 3 0 0 1 2 0 1 2 0 0 3 0 0 1 2 4 4 4 6 5 7 4 4 4 6 5 7 4 4 4 4 6 5 4 4 4 4 6 5 7 4 4 4 6 5 7 4 4 4 4 6 5 4 4 4 4 6 5 7 4 4 4 6 5 7 4 4 4
3 0 0 1 2 0 1 2 0 0 3 0 0 1 2 0 0 3 0 0 1 2 0 1 2 0 0 3 0 0 1 2 0 0 3 0 0 1 2 0 1 2 0 0 3 0 0 5 7 4 4 4 4 6 5 4 4 4 4 6 5 7 4 4 4 6 5 7 4 4 4 4 6 5 4 4 4 4 6 5 7 4 4 4 6 5 7 4 4 4 4 6 5 4 4 4 4 6 5 7
0 0 3 0 0 1 2 0 1 2 0 0 3 0 0 1 2 0 0 3 0 0 1 2 0 1 2 0 0 3 0 0 1 2 0 0 3 0 0 1 2 0 1 2 0 0 3 0 4 6 5 7 4 4 4 6 5 7 4 4 4 4 6 5 4 4 4 4 6 5 7 4 4 4 6 5 7 4 4 4 4 6 5 4 4 4 4 6 5 7 4 4 4 6 5 7 4 4 4 4
1 2 0 0 3 0 0 1 2 0 1 2 0 0 3 0 0 1 2 0 0 3 0 0 1 2 0 1 2 0 0 3 0 0 1 2 0 0 3 0 0 1 2 0 1 2 0 0 4 4 4 4 6 5 4 4 4 4 6 5 7 4 4 4 6 5 7 4 4 4 4 6 5 4 4 4 4 6 5 7 4 4 4 6 5 7 4 4 4 4 6 5 4 4 4 4 6 5 7 4
0 0 1 2 0 0 3 0 0 1 2 0 1 2 0 0 3 0 0 1 2 0 0 3 0 0 1 2 0 1 2 0 0 3 0 0 1 2 0 0 3 0 0 1 2 0 1 2 6 5 7 4 4 4 6 5 7 4 4 4 4 6 5 4 4 4 4 6 5 7 4 4 4 6 5 7 4 4 4 4 6 5 4 4 4 4 6 5 7 4 4 4 6 5 7 4 4 4 4 6
0 3 0 0 1 2 0 0 3 0 0 1 2 0 1 2 0 0 3 0 0 1 2 0 0 3 0 0 1 2 0 1 2 0 0 3 0 0 1 2 0 0 3 0 0 1 2 0 4 4 4 6 5 4 4 4 4 6 5 7 4 4 4 6 5 7 4 4 4 4 6 5 4 4 6 5 5 6 5 6 5 6 6 5 7 4 4 4 4 6 5 4 4 4 4 6 5 7 4 4
2 0 0 3 0 0 1 2 0 0 3 0 0 1 2 0 1 2 0 0 3 0 0 1 2 0 0 3 0 0 1 2 0 1 2 0 0 3 0 0 1 2 0 0 3 0 0 1 2 7 4 4 4 6 5 7 4 4 4 4 6 5 4 4 4 4 6 5 7 4 4 4 6 5 6 5 6 5 6 6 5 6 5 6 5 6 5 7 4 4 4 6 5 7 4 4 4 4 6 5
0 1 2 0 0 3 0 0 1 2 0 0 3 0 0 1 2 0 1 2 0 0 3 0 0 1 2 0 0 3 0 0 1 2 0 1 2 0 0 3 0 0 1 2 0 0 3 0 0 4 6 5 4 4 4 4 6 5 7 4 4 4 6 5 7 4 4 4 4 6 5 6 5 6 5 5 6 5 6 5 6 6 5 6 5 6 4 4 6 5 4 4 4 4 6 5 7 4 4 4
1 2 0 1 2 0 0 3 0 0 1 2 0 0 3 0 0 1 2 0 1 2 0 0 3 0 0 1 2 0 0 3 0 0 1 2 0 1 2 0 0 3 0 0 1 2 0 0 3 4 4 4 6 5 7 4 4 4 4 6 5 4 4 4 4 6 5 7 4 4 6 6 5 6 5 6 5 6 6 5 6 5 6 5 5 6 5 4 4 4 6 5 7 4 4 4 4 6 5 4
0 0 1 2 0 1 2 0 0 3 0 0 1 2 0 0 3 0 0 1 2 0 1 2 0 0 3 0 0 1 2 0 0 3 0 0 1 2 0 1 2 0 0 3 0 0 1 2 0 0 5 4 4 4 4 6 5 7 4 4 4 6 5 7 4 4 4 4 6 5 6 5 6 5 5 6 5 6 5 6 6 5 6 5 6 5 6 6 5 4 4 4 4 6 5 7 4 4 4 6
0 3 0 0 1 2 0 1 2 0 0 3 0 0 1 2 0 0 3 0 0 1 2 0 1 2 0 0 3 0 0 1 2 0 0 3 0 0 1 2 0 1 2 0 0 3 0 0 1 2 4 6 5 7 4 4 4 4 6 5 4 4 4 4 6 5 7 4 5 6 6 5 6 5 6 5 6 6 5 6 5 6 5 5 6 5 6 5 6 6 5 7 4 4 4 4 6 5 4 4
2 0 0 3 0 0 1 2 0 1 2 0 0 3 0 0 1 2 0 0 3 0 0 1 2 0 1 2 0 0 3 0 0 1 2 0 0 3 0 0 1 2 0 1 2 0 0 3 0 0 4 4 4 4 6 5 7 4 4 4 6 5 7 4 4 4 4 6 5 6 5 6 5 5 6 5 6 5 6 6 5 6 5 6 5 6 6 5 6 4 4 4 6 5 7 4 4 4 6 5
0 1 2 0 0 3 0 0 1 2 0 1 2 0 0 3 0 0 1 2 0 0 3 0 0 1 2 0 1 2 0 0 3 0 0 1 2 0 0 3 0 0 1 2 0 1 2 0 0 3 6 5 7 4 4 4 4 6 5 4 4 4 4 6 5 7 4 5 6 6 5 6 5 6 5 6 6 5 6 5 6 5 5 6 5 6 5 6 6 5 7 4 4 4 4 6 5 4 4 4
3 0 0 1 2 0 0 3 0 0 1 2 0 1 2 0 0 3 0 0 1 2 0 0 3 0 0 1 2 0 1 2 0 0 3 0 0 1 2 0 0 3 0 0 1 2 0 1 2 0 0 4 4 6 5 7 4 4 4 6 5 7 4 4 4 4 6 5 6 5 6 5 5 6 5 6 5 6 6 5 6 5 6 5 6 6 5 6 5 6 4 6 5 7 4 4 4 6 5 7
0 0 3 0 0 1 2 0 0 3 0 0 1 2 0 1 2 0 0 3 0 0 1 2 0 0 3 0 0 1 2 0 1 2 0 0 3 0 0 1 2 0 0 3 0 0 1 2 0 1 2 7 4 4 4 4 6 5 4 4 4 4 6 5 7 4 4 6 6 5 6 5 6 5 6 6 5 6 5 6 5 5 6 5 6 5 6 6 5 6 4 4 4 4 6 5 4 4 4 4
1 2 0 0 3 0 0 1 2 0 0 3 0 0 1 2 0 1 2 0 0 3 0 0 1 2 0 0 3 0 0 1 2 0 1 2 0 0 3 0 0 1 2 0 0 3 0 0 1 2 0 4 6 5 7 4 4 4 6 5 7 4 4 4 4 6 5 6 5 6 5 5 6 5 6 5 6 6 5 6 5 6 5 6 6 5 6 5 6 5 6 5 7 4 4 4 6 5 7 4
2 0 1 2 0 0 3 0 0 1 2 0 0 3 0 0 1 2 0 1 2 0 0 3 0 0 1 2 0 0 3 0 0 1 2 0 1 2 0 0 3 0 0 1 2 0 0 3 0 0 1 2 4 4 4 6 5 4 4 4 4 6 5 7 4 4 4 6 5 6 5 6 5 6 6 5 6 5 6 5 5 6 5 6 5 6 6 5 6 5 4 4 4 6 5 4 4 4 4 6
0 1 2 0 1 2 0 0 3 0 0 1 2 0 0 3 0 0 1 2 0 1 2 0 0 3 0 0 1 2 0 0 3 0 0 1 2 0 1 2 0 0 3 0 0 1 2 0 0 3 0 0 5 7 4 4 4 6 5 7 4 4 4 4 6 5 4 5 6 5 5 6 5 6 5 6 6 5 6 5 6 5 6 6 5 6 5 6 5 5 5 7 4 4 4 6 5 7 4 4
3 0 0 1 2 0 1 2 0 0 3 0 0 1 2 0 0 3 0 0 1 2 0 1 2 0 0 3 0 0 1 2 0 0 3 0 0 1 2 0 1 2 0 0 3 0 0 1 2 0 0 3 4 4 6 5 4 4 4 4 6 5 7 4 4 4 6 5 6 5 6 5 6 6 5 6 5 6 5 5 6 5 6 5 6 6 5 6 5 6 4 4 6 5 4 4 4 4 6 5
0 0 3 0 0 1 2 0 1 2 0 0 3 0 0 1 2 0 0 3 0 0 1 2 0 1 2 0 0 3 0 0 1 2 0 0 3 0 0 1 2 0 1 2 0 0 3 0 0 1 2 0 7 4 4 4 6 5 7 4 4 4 4 6 5 4 4 6 5 5 6 5 6 5 6 6 5 6 5 6 5 6 6 5 6 5 6 5 5 6 7 4 4 4 6 5 7 4 4 4
1 2 0 0 3 0 0 1 2 0 1 2 0 0 3 0 0 1 2 0 0 3 0 0 1 2 0 1 2 0 0 3 0 0 1 2 0 0 3 0 0 1 2 0 1 2 0 0 3 0 0 1 2 6 5 4 4 4 4 6 5 7 4 4 4 6 5 6 5 6 5 6 6 5 6 5 6 5 5 6 5 6 5 6 6 5 6 5 6 5 4 6 5 4 4 4 4 6 5 7
0 0 1 2 0 0 3 0 0 1 2 0 1 2 0 0 3 0 0 1 2 0 0 3 1 2 2 3 1 1 2 3 1 3 0 0 1 2 0 0 3 0 0 1 2 0 1 2 0 0 3 0 0 4 4 6 5 7 4 4 4 4 6 5 4 4 4 4 5 6 5 6 5 6 6 5 6 5 6 5 6 6 5 6 5 6 5 5 6 7 4 4 4 6 5 7 4 4 4 4
0 3 0 0 1 2 0 0 3 0 0 1 12 12 12 2 0 0 3 0 0 1 2 2 3 3 1 2 2 3 1 1 2 3 0 3 0 0 1 2 0 0 3 0 0 1 2 0 1 2 0 0 3 5 4 4 4 4 6 5 7 4 4 4 6 5 7 4 6 5 6 6 5 6 5 6 5 5 6 5 6 5 6 6 5 6 5 6 5 4 6 5 4 4 4 4 6 5 7 4
2 0 0 3 0 0 1 2 0 0 3 0 12 12 12 12 12 12 0 0 3 2 3 3 1 2 3 3 1 2 2 3 1 1 2 3 0 3 0 0 1 2 0 0 3 0 0 1 2 0 1 2 0 0 6 5 7 4 4 4 4 6 5 4 4 4 4 6 5 5 6 5 6 6 5 6 5 6 5 6 6 5 6 5 6 5 5 6 7 4 4 4 6 5 7 4 4 4 4 6
0 1 2 0 0 3 0 0 1 2 0 0 3 0 0 12 12 12 12 12 0 1 1 2 3 3 1 2 3 3 1 2 2 3 1 1 2 0 0 3 0 0 1 2 0 0 3 0 0 1 2 0 1 2 4 4 4 6 5 7 15 16 17 6 5 7 4 4 4 4 6 5 6 5 6 5 5 6 5 6 5 6 6 5 6 5 6 4 4 6 5 4 4 4 4 6 5 7 4 4
1 2 0 1 2 0 0 3 0 0 1 2 0 0 3 0 0 1 12 12 12 12 12 1 1 2 3 3 1 2 3 3 1 2 2 3 1 1 2 0 0 3 0 0 1 2 0 0 3 0 0 1 2 0 5 7 4 4 4 4 18 20 18 4 4 4 6 5 7 4 4 6 6 5 6 5 6 5 6 6 5 6 5 6 5 5 5 7 4 4 4 6 5 7 4 4 4 4 6 5
0 0 1 2 0 1 2 0 0 3 0 0 1 2 0 0 3 0 0 2 12 12 12 12 12 12 1 2 3 3 1 2 3 3 1 2 2 3 0 1 2 0 0 3 0 0 1 2 0 0 3 0 0 1 4 4 6 5 7 4 18 19 18 5 7 4 4 4 4 6 5 4 5 6 5 5 6 5 6 5 6 6 5 6 5 4 4 4 6 5 4 4 4 4 6 5 7 4 4 4
0 3 0 0 1 2 0 1 2 0 0 3 0 0 1 2 0 0 3 1 2 2 12 12 12 12 12 12 12 2 3 3 1 2 3 3 1 2 1 2 0 1 2 0 0 3 0 0 1 2 0 0 3 0 0 4 4 4 4 6 12 12 12 4 4 6 5 7 4 4 4 6 5 7 5 6 5 6 6 5 6 5 6 4 6 5 7 4 4 4 6 5 7 4 4 4 4 6 5 4
2 0 0 3 0 0 1 2 0 1 2 0 0 3 0 0 1 2 0 3 3 1 2 12 12 1 12 12 12 12 12 12 3 3 1 2 3 3 0 0 1 2 0 1 2 0 0 3 0 0 1 2 0 0 3 6 5 7 4 13 4 6 5 14 4 4 4 4 6 5 4 4 4 4 6 5 7 4 4 4 6 5 7 4 4 4 4 6 5 4 4 4 4 6 5 7 4 4 4 6
0 1 2 0 0 3 0 0 1 2 0 1 2 0 0 3 0 0 1 1 2 3 3 12 12 2 3 1 1 12 12 12 12 12 12 3 1 2 0 3 0 0 1 2 0 1 2 0 0 3 0 0 1 2 0 4 4 4 6 5 4 4 4 4 6 5 7 4 4 4 6 5 7 4 4 4 4 6 5 4 4 4 4 6 5 7 4 4 4 6 5 7 4 4 4 4 6 5 4 4
3 0 0 1 2 0 0 3 0 0 1 2 0 1 2 0 0 3 0 3 3 1 2 3 12 12 2 2 3 1 1 2 12 12 12 12 12 12 2 0 0 3 0 0 1 2 0 1 2 0 0 3 0 0 1 5 7 4 4 4 6 5 7 4 4 4 4 6 5 4 4 4 4 6 5 7 4 4 4 6 5 7 4 4 4 4 6 5 4 4 4 4 6 5 7 4 4 4 6 5
0 0 3 0 0 1 2 0 0 3 0 0 1 2 0 1 2 0 0 1 2 3 3 1 12 12 3 1 2 2 3 1 1 2 3 12 12 12 12 12 2 0 0 3 0 0 1 2 0 1 2 0 0 3 0 0 4 6 5 4 4 4 4 6 5 7 4 4 4 6 5 7 4 4 4 4 6 5 4 4 4 4 6 5 7 4 4 4 6 5 7 4 4 4 4 6 5 4 4 4
1 2 0 0 3 0 0 1 2 0 0 3 0 0 1 2 0 1 2 3 1 1 2 3 3 12 12 3 3 1 2 2 3 1 1 2 3 1 12 12 12 12 12 0 0 3 0 0 1 2 0 1 2 0 0 3 4 4 4 6 5 7 4 4 4 4 6 5 4 4 4 4 6 5 7 4 4 4 6 5 7 4 4 4 4 6 5 4 4 4 4 6 5 7 4 4 4 6 5 7
2 0 1 2 0 0 3 0 0 1 2 0 0 3 0 0 1 2 0 1 2 3 1 1 2 3 12 12 2 3 3 1 2 2 3 1 1 2 0 0 12 12 12 12 12 12 0 3 0 0 1 2 0 1 2 0 6 5 4 4 4 4 6 5 7 4 4 4 6 5 7 4 4 4 4 6 5 4 4 4 4 6 5 7 4 4 4 6 5 7 4 4 4 4 6 5 4 4 4 4
0 1 2 0 1 2 0 0 3 0 0 1 2 0 0 3 0 0 1 3 1 1 2 3 1 1 12 12 3 1 2 3 3 1 2 2 3 1 1 2 0 0 3 12 12 12 12 12 12 3 0 0 1 2 0 1 2 4 6 5 7 4 4 4 4 6 5 4 4 4 4 6 5 7 4 4 4 6 5 7 4 4 4 4 6 5 4 4 4 4 6 5 7 4 4 4 6 5 7 4
3 0 0 1 2 0 1 2 0 0 3 0 0 1 2 0 0 3 0 0 2 3 1 1 2 3 1 12 12 3 3 1 2 3 3 1 2 1 2 0 1 2 0 0 3 0 12 12 12 12 12 12 0 0 1 2 0 4 4 4 4 6 5 7 4 4 4 6 5 7 4 4 4 4 6 5 4 4 4 4 6 5 7 4 4 4 6 5 7 4 4 4 4 6 5 4 4 4 4 6
0 0 3 0 0 1 2 0 1 2 0 0 3 0 0 1 2 0 0 3 0 2 2 3 1 1 2 12 12 1 2 3 3 1 2 3 3 0 0 1 2 0 1 2 0 0 3 0 0 12 12 12 12 12 12 0 1 6 5 7 4 4 4 4 6 5 4 4 4 4 6 5 7 4 4 4 6 5 7 4 4 4 4 6 5 4 4 4 4 6 5 7 4 4 4 6 5 7 4 4
1 2 0 0 3 0 0 1 2 0 1 2 0 0 3 0 0 1 2 0 0 3 1 2 2 3 1 1 12 12 1 1 2 3 3 1 0 0 3 0 0 1 2 0 1 2 0 0 3 0 0 1 12 12 12 12 12 12 4 4 6 5 7 4 4 4 6 5 7 4 4 4 4 6 5 4 4 4 4 6 5 7 4 4 4 6 5 7 4 4 4 4 6 5 4 4 4 4 6 5
0 0 1 2 0 0 3 0 0 1 2 0 1 2 0 0 3 0 0 1 2 0 0 3 1 2 2 3 1 12 12 3 15 16 17 0 1 2 0 0 3 0 0 1 2 0 1 2 0 0 3 0 0 1 2 12 12 12 12 12 4 4 4 6 5 4 4 4 4 6 5 7 4 4 4 6 5 7 4 4 4 4 6 5 4 4 4 4 6 5 7 4 4 4 6 5 7 4 4 4
0 3 0 0 1 2 0 0 3 0 0 1 2 0 1 2 0 0 3 0 0 1 2 0 3 3 1 2 2 12 12 1 18 20 18 3 0 0 1 2 0 0 3 0 0 1 2 0 1 2 0 0 3 0 0 1 2 0 12 12 12 12 12 4 4 6 5 7 4 4 4 4 6 5 4 4 4 4 6 5 7 4 4 4 6 5 7 4 4 4 4 6 5 4 4 4 4 6 5 7
2 0 0 3 0 0 1 2 0 0 3 0 0 1 2 0 1 2 0 0 3 0 0 1 2 0 0 3 0 0 12 12 18 19 18 0 0 3 0 0 1 2 0 0 3 0 0 1 2 0 1 2 0 0 3 0 0 1 4 4 12 12 12 12 12 12 4 4 6 5 7 4 4 4 6 5 7 4 4 4 4 6 5 4 4 4 4 6 5 7 4 4 4 6 5 7 4 4 4 4
0 1 2 0 0 3 0 0 1 2 0 0 3 0 0 1 2 0 1 2 0 0 3 0 0 1 2 0 0 3 12 12 12 12 12 1 2 0 0 3 0 0 1 2 0 0 3 0 0 1 2 0 1 2 0 0 3 0 9 11 7 4 4 12 12 12 12 12 12 4 4 6 5 4 4 4 4 6 5 7 4 4 4 6 5 7 4 4 4 4 6 5 4 4 4 4 6 5 7 4
1 2 0 1 2 0 0 3 0 0 1 2 0 0 3 0 0 1 2 0 1 2 0 0 3 0 0 1 2 0 0 13 12 0 1 14 0 1 2 0 0 3 0 0 1 2 0 0 3 0 0 1 2 0 1 2 0 10 8 10 10 9 10 4 4 4 12 12 12 12 12 12 4 6 5 7 4 4 4 4 6 5 4 4 4 4 6 5 7 4 4 4 6 5 7 4 4 4 4 6
0 0 1 2 0 1 2 0 0 3 0 0 1 2 0 0 3 0 0 1 2 0 1 2 0 0 3 0 0 1 2 0 12 12 0 0 1 2 0 1 2 0 0 3 0 0 1 2 0 0 3 0 0 1 2 10 10 9 10 10 9 11 10 10 8 10 10 4 4 12 12 12 12 12 12 4 6 5 7 4 4 4 6 5 7 4 4 4 4 6 5 4 4 4 4 6 5 7 4 4
0 3 0 0 1 2 0 1 2 0 0 3 0 0 1 2 0 0 3 0 0 1 2 0 1 2 0 0 3 0 0 1 12 12 0 3 0 0 1 2 0 1 2 0 0 3 0 0 1 2 0 0 3 0 10 10 9 11 10 10 8 10 10 8 10 10 9 11 10 9 4 4 12 12 12 12 12 12 4 6 5 4 4 4 4 6 5 7 4 4 4 6 5 7 4 4 4 4 6 5
2 0 0 3 0 0 1 2 0 1 2 0 0 3 0 0 1 2 0 0 3 0 0 1 2 0 1 2 0 0 3 0 0 12 12 0 0 3 0 0 1 2 0 1 2 0 0 3 0 0 1 2 0 11 10 10 8 10 10 8 10 10 9 11 10 9 11 10 10 8 10 10 9 11 4 12 12 12 12 12 4 6 5 7 4 4 4 4 6 5 4 4 4 4 6 5 7 4 4 4
0 1 2 0 0 3 0 0 1 2 0 1 2 0 0 3 0 0 1 2 0 0 3 0 0 1 2 0 1 2 0 0 3 12 12 1 2 0 0 3 0 0 1 2 0 1 2 0 12 12 12 12 12 10 10 8 10 10 9 11 10 9 11 10 10 8 10 10 9 11 10 9 11 10 10 8 10 4 12 12 12 12 12 4 6 5 7 4 4 4 6 5 7 4 4 4 4 6 5 4
3 0 0 1 2 0 0 3 0 0 1 2 0 1 2 0 0 3 0 0 1 2 0 0 3 0 0 1 2 0 1 2 0 0 12 12 0 1 2 0 0 3 0 0 1 2 0 1 12 12 12 12 12 10 9 11 10 9 11 10 10 8 10 10 9 11 10 9 11 10 10 8 10 10 8 10 10 9 11 10 12 12 12 12 12 12 4 6 5 4 4 4 4 6 5 7 4 4 4 6
0 0 3 0 0 1 2 0 0 3 0 0 1 2 0 1 2 0 0 3 0 0 1 2 0 0 3 0 0 1 2 0 1 2 0 12 12 0 0 1 2 0 0 3 0 0 1 2 12 12 12 12 12 9 11 10 10 8 10 10 9 11 10 9 11 10 10 8 10 10 8 10 10 9 11 10 9 11 10 10 8 10 10 12 12 12 12 12 4 6 5 7 4 4 4 4 6 5 4 4
1 2 0 0 3 0 0 1 2 0 0 3 0 0 1 2 0 1 2 0 0 3 0 0 1 2 0 0 3 0 0 1 2 0 1 12 12 0 3 0 0 1 2 0 0 3 0 0 12 12 12 12 12 8 10 10 9 11 10 9 11 10 10 8 10 10 8 10 10 9 11 10 9 11 10 10 8 10 10 9 10 10 9 11 10 10 12 12 4 4 4 4 6 5 7 4 4 4 6 5
2 0 1 2 0 0 3 0 0 1 2 0 0 3 0 0 1 2 0 1 2 0 0 3 0 0 1 2 0 0 3 0 0 1 2 0 12 12 0 0 3 0 15 16 16 16 16 17 12 12 12 12 12 11 10 9 11 10 10 8 10 10 8 10 10 9 11 10 9 11 10 10 8 10 10 9 10 10 9 11 10 10 8 10 10 8 10 10 9 11 10 4 4 4 4 6 5 4 4 4
0 1 2 0 1 2 0 0 3 0 0 1 2 0 0 3 0 0 1 2 0 1 2 0 0 3 0 0 1 2 0 0 3 0 0 1 12 12 1 2 0 0 18 19 19 19 19 18 9 11 10 9 11 10 10 8 10 10 8 10 10 9 11 10 9 11 10 10 8 10 10 9 10 10 9 11 10 10 8 10 10 8 10 10 9 11 10 9 11 10 10 8 10 10 9 4 4 6 5 7
3 0 0 1 2 0 1 2 0 0 3 0 0 1 2 0 0 3 0 0 1 2 0 1 2 0 0 3 0 0 1 2 0 0 3 0 0 12 12 0 1 2 18 19 20 20 19 18 11 10 10 8 10 10 8 10 10 9 11 10 9 11 10 10 8 10 10 9 10 10 9 11 10 10 8 10 10 8 10 10 9 11 10 9 11 10 10 8 10 10 9 10 10 9 11 10 10 8 4 4
0 0 3 0 0 1 2 0 1 2 0 0 3 0 0 1 2 0 0 3 0 0 1 2 0 1 2 0 0 3 0 0 1 2 0 0 3 0 12 12 2 0 12 12 12 12 12 12 10 10 8 10 10 9 11 10 9 11 10 10 8 10 10 9 10 10 9 11 10 10 8 10 10 8 10 10 9 11 10 9 11 10 10 8 10 10 9 10 10 9 11 10 10 8 10 10 8 10 10 9
1 2 0 0 3 0 0 1 2 0 1 2 0 0 3 0 0 1 2 0 0 3 0 0 1 2 0 1 2 0 0 3 0 0 1 2 0 0 12 12 0 13 10 8 10 10 8 10 14 9 11 10 9 11 10 10 8 10 10 9 10 10 9 11 10 10 8 10 10 8 10 10 9 11 10 9 11 10 10 8 10 10 9 10 10 9 11 10 10 8 10 10 8 10 10 9 11 10 9 11
0 0 1 2 0 0 3 0 0 1 2 0 1 2 0 0 3 0 0 1 2 0 0 3 0 0 1 2 0 1 2 0 0 3 0 0 1 2 0 12 12 10 8 10 10 9 11 10 9 11 10 10 8 10 10 9 10 10 9 11 10 10 8 10 10 8 10 10 9 11 10 9 11 10 10 8 10 10 9 10 10 9 11 10 10 8 10 10 8 10 10 9 11 10 9 11 10 10 8 10
0 3 0 0 1 2 0 0 3 0 0 1 2 0 1 2 0 0 3 0 0 1 2 0 0 3 0 0 1 2 0 1 2 0 0 3 0 0 1 12 12 9 11 10 9 11 10 10 8 10 10 9 10 10 9 11 10 10 8 10 10 8 10 10 9 11 10 9 11 10 10 8 10 10 9 10 10 9 11 10 10 8 10 10 8 10 10 9 11 10 9 11 10 10 8 10 10 9 10 10
2 0 0 3 0 0 1 2 0 0 3 0 0 1 2 0 1 2 0 0 3 0 0 1 2 0 0 3 0 0 1 2 0 1 2 0 0 3 11 10 12 12 10 10 8 10 10 9 10 10 9 11 10 10 8 10 10 8 10 10 9 11 10 9 11 10 10 8 10 10 9 10 10 9 11 10 10 8 10 10 8 10 10 9 11 10 9 11 10 10 8 10 10 9 10 10 9 11 10 10
0 1 2 0 0 3 0 0 1 2 0 0 3 0 0 1 2 0 1 2 0 0 3 0 0 1 2 0 0 3 0 0 1 2 0 1 2 11 10 10 8 12 12 9 10 10 9 11 10 10 8 10 10 8 10 10 9 11 10 9 11 10 10 8 10 10 9 10 10 9 11 10 10 8 10 10 8 10 10 9 11 10 9 11 10 10 8 10 10 9 10 10 9 11 10 10 8 10 10 8
1 2 0 1 2 0 0 3 0 0 1 2 0 0 3 0 0 1 2 0 1 2 0 0 3 0 0 1 2 0 0 3 0 0 1 2 8 10 10 9 10 12 12 11 10 10 8 10 10 8 10 10 9 11 10 9 11 10 10 8 10 10 9 10 10 9 11 10 10 8 10 10 8 10 10 9 11 10 9 11 10 10 8 10 10 9 10 10 9 11 10 10 8 10 10 8 10 10 9 11
0 0 1 2 0 1 2 0 0 3 0 0 1 2 0 0 3 0 0 1 2 0 1 2 0 0 3 0 0 1 2 0 0 3 10 9 10 10 9 11 10 10 12 12 10 8 10 10 9 11 10 9 11 10 10 8 10 10 9 10 10 9 11 10 10 8 10 10 8 10 10 9 11 10 9 11 10 10 8 10 10 9 10 10 9 11 10 10 8 10 10 8 10 10 9 11 10 9 11 10
0 3 0 0 1 2 0 1 2 0 0 3 0 0 1 2 0 0 3 0 0 1 2 0 1 2 0 0 3 0 0 1 2 10 9 11 10 10 8 10 10 8 12 12 9 11 10 9 11 10 10 8 10 10 9 10 10 9 11 10 10 8 10 10 8 10 10 9 11 10 9 11 10 10 8 10 10 9 10 10 9 11 10 10 8 10 10 8 10 10 9 11 10 9 11 10 11 8 10 10
2 0 0 3 0 0 1 2 0 1 2 0 0 3 0 0 1 2 15 16 16 16 16 17 2 0 1 2 0 0 3 0 10 10 8 10 10 8 10 10 9 11 10 12 12 10 10 8 10 10 9 10 10 9 11 10 10 8 8 10 8 10 9 11 9 8 9 11 10 10 8 10 10 9 10 10 9 11 10 10 8 10 10 8 10 10 9 11 10 9 11 10 11 8 10 10 9 10 10 9
0 1 2 0 0 3 0 0 1 2 0 1 2 0 0 3 0 0 18 19 19 19 19 18 0 1 2 0 1 2 0 10 10 8 10 10 9 11 10 9 11 10 10 8 12 12 9 10 10 9 11 10 10 8 10 10 8 10 9 11 9 8 9 8 10 9 10 9 8 9 10 10 9 11 10 10 8 10 10 8 10 10 9 11 10 9 11 10 11 8 10 10 9 10 10 9 11 10 10 8
3 0 0 1 2 0 0 3 0 0 1 2 0 1 2 0 0 3 18 19 20 20 19 18 3 0 0 1 2 8 10 10 9 11 10 9 11 10 10 8 10 10 9 10 12 12 11 10 10 8 10 10 8 10 10 11 9 8 9 8 10 9 10 9 8 9 8 10 8 10 10 10 8 10 10 8 10 10 9 11 10 9 11 10 11 8 10 10 9 10 10 9 11 10 10 8 10 10 8 10
0 0 3 0 0 1 2 0 0 3 0 0 1 2 0 1 2 0 12 12 12 12 12 12 0 0 3 0 9 11 10 9 11 10 10 8 10 10 9 10 10 9 11 10 10 12 12 10 8 10 10 9 11 10 9 8 10 9 10 9 8 9 8 10 8 10 9 8 9 8 10 8 10 10 9 11 10 9 11 10 11 8 10 10 9 10 10 9 11 10 10 8 10 10 8 10 10 9 11 10
1 2 0 0 3 0 0 1 2 0 0 3 0 0 1 2 0 13 2 0 0 3 0 0 14 2 0 9 11 10 10 8 10 10 9 10 10 9 11 10 10 8 10 10 8 12 12 9 11 10 9 11 10 9 10 9 8 9 8 10 8 10 9 8 9 8 10 8 10 9 10 9 10 9 11 10 11 8 10 10 9 10 10 9 11 10 10 8 10 10 8 10 10 9 11 10 9 11 10 10
12 0 1 2 0 0 3 0 0 1 2 0 0 3 0 0 1 2 0 1 2 0 0 3 0 0 10 8 10 10 9 10 10 9 11 10 10 8 10 10 8 10 10 9 11 10 12 12 10 10 8 10 10 9 8 10 8 10 9 8 9 8 10 8 10 9 10 9 8 9 8 10 11 8 10 10 9 10 10 9 11 10 10 8 10 10 8 10 10 9 11 10 9 11 10 10 8 10 10 9
12 12 12 0 1 2 0 0 3 0 0 1 2 0 0 3 0 0 1 2 0 1 2 0 0 10 9 10 10 9 11 10 10 8 10 10 8 10 10 9 11 10 9 11 10 10 8 12 12 9 10 10 8 10 9 8 9 8 10 8 10 9 10 9 8 9 8 10 9 10 9 8 9 10 15 16 16 16 16 17 10 10 8 10 10 9 11 10 9 11 10 10 8 10 10 9 10 11 9 11
12 12 12 12 2 0 1 2 0 0 3 0 0 1 2 0 0 3 0 0 1 2 0 10 10 9 11 10 10 8 10 10 8 10 10 9 11 10 9 11 10 10 8 10 10 9 10 12 12 11 10 10 9 8 10 8 10 9 10 9 8 9 8 10 9 10 9 8 9 8 10 8 10 10 18 19 19 19 19 18 10 9 11 10 9 11 10 10 8 10 10 9 10 11 9 11 10 10 8 10
12 12 12 12 12 12 2 0 1 2 0 0 3 0 0 1 2 0 0 3 0 0 11 10 10 8 10 10 8 10 10 9 11 10 9 11 10 10 8 10 10 9 10 10 9 11 10 10 12 12 10 8 10 9 10 9 8 9 8 10 9 10 9 8 9 8 10 8 10 9 8 9 8 10 18 19 20 20 19 18 9 11 10 10 8 10 10 9 10 11 9 11 10 10 8 10 10 8 10 10
14 12 12 12 12 12 12 12 2 0 1 2 0 0 3 0 0 1 2 0 0 8 10 10 8 10 10 9 11 10 9 11 10 10 8 10 10 9 10 10 9 11 10 10 8 10 10 8 12 12 9 11 8 9 8 10 9 10 9 8 9 8 10 8 10 9 8 9 8 10 8 10 9 9 12 12 12 12 12 12 8 10 10 9 10 11 9 11 10 10 8 10 10 8 10 10 9 11 10 9
12 13 12 12 12 12 12 12 12 12 2 0 1 2 0 0 3 0 0 1 8 10 10 9 11 10 9 11 10 10 8 10 10 9 10 10 9 11 10 10 8 10 10 8 10 10 9 11 10 12 12 10 9 10 9 8 9 8 10 8 10 9 8 9 8 10 8 10 9 10 9 8 9 13 10 10 8 10 10 9 14 11 9 11 10 10 8 10 10 8 10 10 9 11 10 9 11 10 10 8
12 12 12 12 12 12 12 12 12 12 12 12 2 0 1 2 0 0 10 9 11 10 9 11 10 10 8 10 10 9 10 10 9 11 10 10 8 10 10 8 10 10 9 11 10 9 11 10 11 8 12 12 9 8 10 8 10 9 8 9 8 10 8 10 9 10 9 8 9 8 10 9 10 10 10 9 10 11 9 11 10 10 8 10 10 8 10 10 9 11 10 9 11 10 10 8 10 10 9 10
12 12 12 12 12 12 12 12 14 12 12 12 12 12 12 0 1 10 9 11 10 10 8 10 10 9 10 10 9 11 10 10 8 10 10 8 10 10 9 11 10 9 11 10 11 8 10 10 9 10 12 12 10 9 8 9 8 10 8 10 9 10 9 8 9 8 10 9 10 9 8 9 8 11 9 11 10 10 8 10 10 8 10 10 9 11 10 9 11 10 10 8 10 10 9 10 10 9 11 10
12 12 12 12 12 12 12 12 12 13 12 12 12 12 12 12 12 10 8 10 10 9 10 10 9 11 10 10 8 10 10 8 10 10 9 11 10 9 11 10 11 8 10 10 9 10 10 9 11 10 10 12 12 10 8 10 9 10 9 8 9 8 10 9 10 9 8 9 8 11 8 10 9 10 8 10 10 8 10 10 9 11 10 9 11 10 10 8 10 10 9 10 10 9 11 10 10 8 11 10
12 12 12 14 12 12 12 12 12 12 12 12 12 12 12 12 12 9 10 10 9 11 10 10 8 10 10 8 10 10 9 11 10 9 11 10 11 8 10 10 9 10 10 9 11 10 10 8 10 10 8 12 12 10 9 8 9 8 10 9 10 9 8 9 8 11 8 10 9 8 9 8 10 8 10 10 9 11 10 9 11 10 10 8 10 10 9 10 10 9 11 10 10 8 11 10 8 10 10 9
12 12 12 12 13 12 12 12 12 12 12 12 12 12 12 12 14 11 10 10 8 10 10 8 10 10 9 11 10 9 11 10 11 8 10 10 9 10 10 9 11 10 10 8 10 10 8 10 10 9 11 10 12 12 10 9 10 9 8 9 8 11 8 10 9 8 9 8 10 8 10 9 9 11 10 9 11 10 10 8 10 10 9 10 10 9 11 10 10 8 11 10 8 10 10 9 11 10 9 11
12 12 12 12 12 12 12 12 12 12 12 12 12 12 12 12 12 10 10 8 10 10 9 11 10 9 11 10 11 8 10 10 9 10 10 9 11 10 10 8 10 10 8 10 10 9 11 10 9 11 10 10 8 12 12 9 8 11 8 10 9 8 9 8 10 8 10 9 10 9 8 9 11 10 10 8 10 10 9 10 10 9 11 10 10 8 11 10 8 10 10 9 11 10 9 11 10 10 8 10
12 12 12 12 12 12 12 12 12 12 12 14 12 12 12 12 12 10 9 11 10 9 11 10 11 8 10 10 9 10 10 9 11 10 10 8 10 10 8 10 10 9 11 10 9 11 10 10 8 10 10 9 10 12 12 10 9 8 9 8 10 8 10 9 10 9 8 9 8 10 9 8 10 10 9 10 10 9 11 10 10 8 11 10 8 10 10 9 11 10 9 11 10 10 8 10 10 9 10 10
12 12 12 12 12 12 12 12 12 12 12 12 13 12 12 12 12 9 11 10 15 16 17 10 9 10 10 9 11 10 10 8 10 10 8 10 10 9 11 10 9 11 10 10 8 10 10 9 10 11 9 11 10 10 12 12 10 8 10 9 10 9 8 9 8 10 9 10 9 8 9 10 10 9 11 10 10 8 11 10 8 10 10 9 11 10 9 11 10 10 8 10 10 9 10 10 9 11 10 10
12 12 12 12 12 12 14 12 12 12 12 12 12 12 12 12 12 8 10 10 18 20 18 9 11 10 10 8 10 10 8 10 10 9 11 10 9 11 10 10 8 10 10 9 10 11 9 11 10 10 8 10 10 8 12 12 10 9 8 9 8 10 9 10 9 8 9 8 10 9 11 10 10 8 11 10 8 10 10 9 11 10 9 11 10 10 8 10 10 9 10 10 9 11 10 10 8 10 10 8
12 12 12 12 12 12 12 13 12 12 12 12 12 12 12 12 12 12 10 9 18 19 18 8 10 10 8 10 10 9 11 10 9 11 10 10 8 10 10 9 10 11 9 11 10 10 8 10 10 8 10 10 9 11 10 12 12 10 9 10 9 8 9 8 10 8 10 10 10 8 11 10 8 10 10 9 11 10 9 11 10 10 8 10 10 9 10 10 9 11 10 10 8 10 10 8 10 10 9 11
12 14 12 12 12 12 12 12 12 12 12 12 12 12 12 12 12 12 10 8 12 12 12 10 10 9 11 10 9 11 10 10 8 10 10 9 10 11 9 11 10 10 8 10 10 8 10 10 9 11 10 9 11 10 10 8 12 12 9 10 10 9 11 10 10 8 11 10 8 10 10 9 11 10 9 11 10 10 8 10 10 9 10 10 9 11 10 10 8 10 10 8 10 10 9 11 10 9 11 10
12 12 13 12 12 12 12 12 12 12 12 12 12 12 14 12 12 12 8 13 10 9 11 14 9 11 10 10 8 10 10 9 10 11 9 11 10 10 8 10 10 8 10 10 9 11 10 9 11 10 10 8 10 10 9 10 12 12 11 10 10 8 11 10 8 10 10 9 11 10 9 11 10 10 8 10 10 9 10 10 9 11 10 10 8 10 10 8 10 10 9 11 10 9 11 10 10 8 10 10
12 12 12 12 12 12 12 12 12 12 12 12 12 12 12 13 12 12 11 10 9 11 10 10 8 10 10 9 10 11 9 11 10 10 8 10 10 8 10 10 9 11 10 9 11 10 10 8 10 10 9 10 10 9 11 10 10 12 12 10 8 10 10 9 11 10 9 11 10 10 8 10 10 9 10 10 9 11 10 10 8 10 10 8 10 10 9 11 10 9 11 10 10 8 10 10 9 10 10 9
12 12 12 12 12 12 12 12 12 14 12 12 12 12 12 12 12 12 12 10 8 10 10 9 10 11 9 11 10 10 8 10 10 8 10 10 9 11 10 9 11 10 10 8 10 10 9 10 10 9 11 10 10 8 11 10 8 12 12 9 11 10 9 11 10 10 8 10 10 9 10 10 9 11 10 10 8 10 10 8 10 10 9 11 10 9 11 10 10 8 10 10 9 10 10 9 11 10 10 8
12 12 12 12 12 12 12 12 12 12 13 12 12 12 12 12 12 12 12 9 10 11 9 11 10 10 8 10 10 8 10 10 9 11 10 9 11 10 10 8 10 10 9 10 10 9 11 10 10 8 11 10 8 10 10 9 11 10 12 12 10 10 8 10 10 9 10 10 9 11 10 10 8 10 10 8 10 10 9 11 10 9 11 10 10 8 10 10 9 10 10 9 11 10 10 8 10 10 8 10
12 12 12 12 14 12 12 12 12 12 12 12 12 12 12 12 12 12 12 11 10 10 8 10 10 8 10 10 9 11 10 9 11 10 10 8 10 10 9 10 10 9 11 10 10 8 11 10 8 10 10 9 11 10 9 11 10 10 8 10 10 9 10 10 9 11 10 10 8 10 10 8 10 10 9 11 10 9 11 10 10 8 10 10 9 10 10 9 11 10 10 8 10 10 8 10 10 9 11 10
12 12 12 12 12 13 12 12 12 12 12 12 12 12 12 12 12 14 12 12 10 8 10 10 9 11 10 9 11 10 10 8 10 10 9 10 10 9 11 10 10 8 11 10 8 10 10 9 11 10 9 11 10 10 8 10 10 9 10 10 9 11 10 10 8 10 10 8 10 10 9 11 10 9 11 10 10 8 10 10 9 10 10 9 11 10 10 8 10 10 8 10 10 9 11 10 9 11 10 10
12 12 12 12 12 12 12 12 12 12 12 12 12 12 12 12 12 12 13 12 9 11 10 9 11 10 10 8 10 10 9 10 10 9 11 10 10 8 11 10 8 10 10 9 11 10 9 11 10 10 8 10 10 9 10 10 9 11 10 10 8 10 10 8 10 10 9 11 10 9 11 10 10 8 10 10 9 10 10 9 11 10 10 8 10 10 8 10 10 9 11 10 9 11 10 10 8 10 10 9
13 12 12 12 12 12 12 12 12 12 12 12 14 12 12 12 12 12 12 12 12 10 10 8 10 10 9 10 10 9 11 10 10 8 11 10 8 10 10 9 11 10 9 11 10 10 8 10 10 9 10 10 9 11 10 10 8 10 10 8 10 10 9 11 10 9 11 10 10 8 10 10 9 10 10 9 11 10 10 8 10 10 8 10 10 9 11 10 9 11 10 10 8 10 10 9 10 10 9 11
12 12 12 12 12 12 12 12 12 12 12 12 12 13 12 12 12 12 12 12 12 10 9 10 10 9 11 10 10 8 11 10 8 10 10 9 11 10 9 11 10 10 8 10 10 9 10 10 9 11 10 10 8 10 10 8 10 10 9 11 10 9 11 10 10 8 10 10 9 10 10 9 11 10 10 8 10 10 8 10 10 9 11 10 9 11 10 10 8 10 10 9 10 10 9 11 10 10 8 10
12 12 12 12 12 12 12 14 12 12 12 12 12 12 12 12 12 12 12 12 12 12 11 10 10 8 11 10 8 10 10 9 11 10 9 11 10 10 8 10 10 9 10 10 9 11 10 10 8 10 10 8 10 10 9 11 10 9 11 10 10 8 10 10 9 10 10 9 11 10 10 8 10 10 8 10 10 9 11 10 9 11 10 10 8 10 10 9 10 10 9 11 10 10 8 10 10 8 10 10
12 12 12 12 12 12 12 12 13 12 12 12 12 12 12 12 12 12 12 12 14 12 11 10 8 10 10 9 11 10 9 11 10 10 8 10 10 9 10 10 9 11 10 10 8 10 10 8 10 10 9 11 10 9 11 10 10 8 10 10 9 10 10 9 11 10 10 8 10 10 8 10 10 9 11 10 9 11 10 10 8 10 10 9 10 10 9 11 10 10 8 10 10 8 10 10 9 11 10 9
12 12 14 12 12 12 12 12 12 12 12 12 12 12 12 12 12 12 12 12 12 13 12 9 11 10 9 11 10 10 8 10 10 9 10 10 9 11 10 10 8 10 10 8 10 10 9 11 10 9 11 10 10 8 10 10 9 10 10 9 11 10 10 8 10 10 8 10 10 9 11 10 9 11 10 10 8 10 10 9 10 10 9 11 10 10 8 10 10 8 10 10 9 11 10 9 11 10 10 8
12 12 12 13 12 12 12 12 12 12 12 12 12 12 12 14 12 12 12 12 12 12 12 11 10 10 8 10 10 9 10 10 9 11 10 10 8 10 10 8 10 10 9 11 10 9 11 10 10 8 10 10 9 10 10 9 11 10 10 8 10 10 8 10 10 9 11 10 9 11 10 10 8 10 10 9 10 10 9 11 10 10 8 10 10 8 10 10 9 11 10 9 11 10 10 8 10 10 9 10
12 12 12 12 12 12 12 12 12 12 12 12 12 12 12 12 13 12 12 12 12 12 12 12 10 9 10 10 9 11 10 10 8 10 10 8 10 10 9 11 10 9 11 10 10 8 10 10 9 10 10 9 11 10 10 8 10 10 8 10 10 9 11 10 9 11 10 10 8 10 10 9 10 10 9 11 10 10 8 10 10 8 10 10 9 11 10 9 11 10 10 8 10 10 9 10 10 9 11 10
