100 100
2 2 2 2 2 2 2 2 2 2 2 2 2 2 2 2 2 2 2 2 2 2 2 2 2 2 2 2 2 2 2 2 2 2 2 2 2 2 2 2 2 2 2 2 2 2 2 2 2 2 2 2 2 2 2 2 2 2 2 2 2 2 2 2 2 2 2 2 2 2 2 2 2 2 2 2 2 2 2 2 2 2 2 2 2 2 2 2 2 2 2 2 2 2 2 2 2 2 2 2
2 2 2 2 2 2 2 2 2 2 2 2 2 2 2 2 2 2 2 2 2 2 2 2 2 2 2 2 2 2 2 2 2 2 2 2 2 2 2 2 2 2 2 2 2 2 2 2 2 2 2 2 2 2 2 2 2 2 2 2 2 2 2 2 2 2 2 2 2 2 2 2 2 2 2 2 2 2 2 2 2 2 2 2 2 2 2 2 2 2 2 2 2 2 2 2 2 2 2 2
2 2 0 0 0 0 0 0 0 0 0 0 0 0 0 0 0 0 0 0 0 0 0 0 0 0 0 0 0 0 0 0 0 0 0 0 0 0 0 0 0 0 0 0 0 0 0 0 2 2 2 2 4 4 4 4 4 4 4 4 4 4 4 4 4 4 4 4 4 4 4 4 4 4 4 4 4 4 4 4 4 4 4 4 4 4 4 4 4 4 4 4 4 4 4 4 4 4 2 2
2 2 0 0 0 0 0 0 0 0 0 0 0 0 0 0 0 0 0 0 0 0 0 0 0 0 0 0 0 0 0 0 0 0 0 0 0 0 0 0 0 0 0 0 0 0 0 0 2 2 2 2 4 4 4 4 4 4 5 4 4 4 4 4 4 4 4 5 4 4 4 4 4 4 4 4 5 4 4 4 4 4 4 4 4 5 4 4 4 4 4 4 4 4 5 4 4 4 2 2
2 2 0 0 1 1 0 0 0 0 0 0 0 0 0 0 1 1 0 0 0 0 0 0 0 0 0 0 1 1 0 0 0 0 0 0 0 0 0 0 1 1 0 0 0 0 0 0 2 2 2 2 4 4 4 4 4 4 4 4 4 4 4 4 4 4 4 4 4 4 4 4 4 4 4 4 4 4 4 4 4 4 4 4 4 4 4 4 4 4 4 4 4 4 4 4 4 4 2 2
2 2 0 0 1 0 2 2 0 0 0 1 1 0 0 0 2 2 0 0 0 2 2 0 0 0 2 2 0 0 0 2 2 0 0 0 2 2 0 0 0 2 2 0 0 0 0 0 2 2 2 2 4 4 4 4 4 4 4 4 4 4 4 4 4 4 4 4 4 4 5 5 4 4 4 4 4 4 4 4 4 4 4 4 4 4 4 4 4 4 4 4 4 4 4 4 4 4 2 2
2 2 0 0 0 0 0 0 0 0 0 0 1 1 0 0 0 0 0 0 0 0 0 0 0 0 0 0 0 0 0 0 0 0 0 0 0 0 0 0 0 0 0 0 0 0 0 0 2 2 2 2 4 4 4 4 7 7 4 4 7 7 4 4 7 7 4 4 7 7 5 5 7 7 4 4 7 7 4 4 7 7 4 4 7 7 4 4 7 7 4 4 7 7 4 4 4 4 2 2
2 2 2 0 0 0 0 0 0 0 0 0 1 1 0 0 0 0 0 0 0 0 0 0 0 0 0 0 0 0 0 0 0 0 0 0 0 0 0 0 0 0 0 0 0 0 0 0 2 2 2 2 4 4 4 4 4 4 4 4 4 4 4 4 4 4 4 4 4 4 5 5 4 4 4 4 4 4 4 4 4 4 4 4 4 4 4 4 4 4 4 4 4 4 4 4 4 4 2 2
2 2 0 0 0 0 0 0 0 0 0 0 1 1 0 0 0 0 0 0 0 0 0 0 0 0 0 0 0 0 0 0 0 0 0 0 0 0 0 0 0 0 0 0 0 0 0 0 2 2 2 2 4 4 4 4 4 4 4 4 4 4 4 4 4 4 4 4 4 4 5 5 4 4 4 4 4 4 4 4 4 4 4 4 4 4 4 4 4 4 4 4 4 4 4 4 4 4 2 2
2 2 0 0 0 1 1 1 0 0 0 0 0 1 1 0 0 0 0 0 0 0 0 0 0 0 0 0 0 0 0 0 0 0 0 0 0 0 0 0 0 0 0 0 0 0 0 0 2 2 2 2 4 4 4 4 4 4 4 4 4 4 4 4 4 4 4 4 4 4 5 5 4 4 4 4 4 4 4 4 4 4 4 4 4 4 4 4 4 4 4 4 4 4 4 4 4 4 2 2
2 2 0 0 0 0 2 2 1 1 1 1 2 1 1 0 2 2 0 0 0 2 2 0 0 0 2 2 0 0 0 2 2 0 0 0 2 2 0 0 0 2 2 0 0 0 0 0 2 2 2 2 4 4 4 4 4 4 4 4 5 4 4 4 4 4 4 4 4 4 5 5 4 4 4 4 4 4 4 4 4 4 4 4 4 4 4 4 4 4 4 4 4 4 4 4 4 4 2 2
2 2 0 0 0 0 0 0 0 0 0 0 1 1 1 1 0 0 0 0 0 0 0 0 0 0 0 0 0 0 0 0 0 0 0 0 0 0 0 0 0 0 0 0 0 0 0 0 2 2 2 2 4 4 4 4 4 4 4 5 6 5 4 4 4 4 4 4 4 4 5 5 4 4 4 4 4 4 4 4 4 4 4 4 4 4 4 4 4 4 4 4 4 4 4 4 4 4 2 2
2 2 0 0 0 0 0 0 0 0 0 0 0 0 1 1 1 1 1 1 3 0 3 0 3 0 3 0 0 0 0 0 0 0 0 0 0 0 0 0 0 0 0 0 0 0 0 0 2 2 2 2 4 4 4 4 7 7 5 6 6 6 5 4 7 7 4 4 7 7 5 5 7 7 4 4 7 7 4 4 7 7 4 4 7 7 4 4 7 7 4 4 7 7 4 4 4 4 2 2
2 2 0 0 0 0 0 0 0 0 0 0 0 0 1 1 0 3 0 3 1 1 1 1 0 3 0 3 0 0 0 0 0 0 0 0 0 0 0 0 0 0 0 0 0 0 0 0 2 2 2 2 4 4 4 4 4 4 4 5 6 5 4 4 4 4 4 4 4 4 5 5 4 4 4 4 4 4 4 4 4 4 4 4 4 4 4 4 4 4 4 4 4 4 4 4 4 4 2 2
2 2 0 0 0 0 0 0 0 0 0 0 0 0 1 1 3 0 3 0 3 0 3 0 1 1 1 1 3 0 0 0 0 0 0 0 0 0 0 0 0 0 0 0 0 0 0 0 2 2 2 2 4 4 4 4 4 4 4 4 5 4 4 4 4 4 4 4 4 4 5 5 4 5 5 5 5 5 4 4 4 4 4 4 4 4 4 4 4 4 4 4 4 4 4 4 4 4 2 2
2 2 0 0 0 0 2 2 0 0 0 2 2 0 0 1 1 3 0 3 1 1 1 1 1 3 2 3 1 1 1 1 2 0 0 0 2 2 0 0 0 2 2 0 0 0 0 0 2 2 2 2 4 4 4 4 4 4 4 4 4 4 4 4 4 4 4 4 4 4 5 5 5 5 5 5 5 5 5 5 4 4 4 4 4 4 4 4 4 4 4 4 4 4 4 4 4 4 2 2
2 2 0 0 1 0 0 0 0 0 0 0 0 0 3 1 1 0 1 1 1 1 1 1 1 1 1 0 3 0 3 0 1 1 1 1 0 0 0 0 0 0 0 0 0 0 0 0 2 2 2 2 4 4 4 4 4 4 4 4 4 4 4 4 4 4 4 4 4 4 5 5 5 6 6 6 6 6 5 5 5 4 4 4 4 4 4 4 5 4 4 4 4 4 4 4 4 4 2 2
2 2 0 0 1 0 0 0 0 0 0 0 0 3 0 1 1 1 1 1 1 1 1 1 1 1 1 1 0 3 0 3 0 0 0 0 1 1 1 1 0 0 0 0 0 0 0 0 2 2 2 2 4 4 4 4 4 4 4 4 4 4 4 4 4 4 4 4 4 5 5 5 6 6 6 6 6 6 6 6 5 5 4 4 4 4 4 5 6 5 4 4 4 4 4 4 4 4 2 2
2 2 0 0 0 0 0 0 0 0 0 0 3 0 3 0 1 1 1 1 1 1 1 1 1 1 1 1 1 0 3 0 3 0 0 0 0 0 0 0 1 1 1 1 0 0 0 0 2 2 2 2 4 4 4 4 7 7 4 4 7 7 4 4 7 7 4 4 5 5 5 5 6 6 6 6 6 6 6 6 6 5 5 4 7 7 5 6 6 6 5 4 7 7 4 4 4 4 2 2
2 2 0 0 0 0 0 0 0 0 0 0 0 3 0 3 1 1 1 1 1 1 1 1 1 1 1 1 1 3 0 3 0 0 0 0 0 0 0 0 0 0 0 0 1 0 0 0 2 2 2 2 4 4 4 4 4 4 4 4 4 4 4 4 4 4 4 4 5 5 5 5 6 6 6 6 6 6 6 6 6 5 5 4 4 4 4 5 6 5 4 4 4 4 4 4 4 4 2 2
2 2 0 0 0 0 2 2 0 0 0 2 3 0 3 1 1 1 1 1 1 1 1 1 1 1 1 1 1 1 3 2 3 0 0 0 2 2 0 0 0 2 2 0 0 0 0 0 2 2 2 2 4 4 4 4 4 4 4 4 4 4 4 4 4 4 4 5 5 6 5 5 6 6 6 6 6 6 6 6 6 6 5 5 4 4 4 4 5 4 4 4 4 4 4 4 4 4 2 2
2 2 0 0 0 0 0 0 0 0 0 0 0 3 0 1 1 1 1 1 1 1 1 1 1 1 1 1 1 1 0 3 0 0 0 0 0 0 0 0 0 0 0 0 0 0 0 0 2 2 2 2 4 4 4 4 4 4 4 4 4 4 4 4 4 4 4 5 5 6 5 5 6 6 6 6 6 6 6 6 6 6 5 5 4 4 4 4 4 4 4 4 4 4 4 4 4 4 2 2
2 2 2 0 0 0 0 0 0 0 0 0 3 0 3 1 1 1 1 1 1 1 1 1 1 1 1 1 1 1 3 0 3 0 0 0 0 0 0 0 0 0 0 0 0 0 0 0 2 2 2 2 4 4 4 4 4 4 4 4 4 4 4 4 4 4 4 5 5 6 5 5 6 6 6 6 6 6 6 6 6 6 5 5 4 4 4 4 4 4 4 4 4 4 4 4 4 4 2 2
2 2 0 0 0 0 0 0 0 0 0 0 0 3 0 1 1 1 1 1 1 1 1 1 1 1 1 1 1 1 0 3 0 0 0 0 0 0 0 0 0 0 0 0 0 0 0 0 2 2 2 2 4 4 4 4 4 4 4 4 4 4 4 4 4 4 4 5 5 6 5 5 6 6 6 6 6 6 6 6 6 6 5 5 4 4 4 4 4 4 4 4 4 4 4 4 4 4 2 2
2 2 0 0 0 0 0 0 0 0 0 0 3 0 3 1 1 1 1 1 1 1 1 1 1 1 1 1 1 1 3 0 3 0 0 0 0 0 0 0 0 0 0 0 0 0 0 0 2 2 2 2 4 4 4 4 7 7 4 4 7 7 4 4 7 7 4 5 5 6 5 5 6 6 6 6 6 6 6 6 6 6 5 5 7 7 4 4 7 7 4 4 7 7 4 4 4 4 2 2
2 2 0 0 0 0 2 2 0 0 0 2 2 3 0 3 1 1 1 1 1 1 1 1 1 1 1 1 1 3 0 3 2 0 0 0 2 2 0 0 0 2 2 0 0 0 0 0 2 2 2 2 4 4 4 4 4 4 4 4 4 4 4 4 4 4 4 4 5 5 5 5 6 6 6 6 6 6 6 6 6 5 5 4 4 4 4 4 4 4 4 4 4 4 4 4 4 4 2 2
2 2 0 0 0 0 0 0 0 0 0 0 3 0 3 0 1 1 1 1 1 1 1 1 1 1 1 1 1 0 3 0 3 0 0 0 0 0 0 0 0 0 0 0 0 0 0 0 2 2 2 2 4 4 4 4 4 4 4 4 4 4 5 4 4 4 4 4 5 5 5 5 6 6 6 6 6 6 6 6 6 5 5 4 4 4 4 4 4 4 4 4 4 4 4 4 4 4 2 2
2 2 0 0 0 0 0 0 0 0 0 0 0 3 0 3 0 1 1 1 1 1 1 1 1 1 1 1 0 3 0 3 0 0 0 0 0 0 0 0 0 0 0 0 0 0 0 0 2 2 2 2 4 4 4 4 4 4 4 4 4 5 6 5 4 4 4 4 4 5 5 5 6 6 6 6 6 6 6 6 5 5 4 4 4 4 4 4 4 4 4 4 4 4 4 4 4 4 2 2
2 2 0 0 1 0 0 0 0 0 0 0 0 0 3 0 3 0 1 1 1 1 1 1 1 1 1 0 3 0 3 0 0 0 0 0 0 0 0 0 0 0 0 0 0 0 0 0 2 2 2 2 4 4 4 4 4 4 4 4 5 6 6 6 5 4 4 4 4 4 5 5 5 6 6 6 6 6 5 5 5 4 4 4 5 4 4 4 4 4 4 4 4 4 4 4 4 4 2 2
2 2 0 0 1 0 0 0 0 0 0 0 0 0 0 3 0 3 0 1 1 1 1 1 1 3 0 3 0 3 0 0 0 0 0 0 0 0 0 0 0 0 0 0 0 0 0 0 2 2 2 2 4 4 4 4 4 4 4 4 4 5 6 5 4 4 4 4 4 4 5 5 5 5 5 5 5 5 5 5 4 4 4 5 6 5 4 4 4 4 4 4 4 4 4 4 4 4 2 2
2 2 0 0 0 0 2 2 0 0 0 2 2 0 0 0 3 2 3 0 1 1 3 0 3 0 3 2 3 0 0 2 2 0 0 0 2 2 0 0 0 2 2 0 0 0 0 0 2 2 2 2 4 4 4 4 7 7 4 4 7 7 5 4 7 7 4 4 7 7 5 5 7 5 5 5 5 5 4 4 7 7 5 6 6 6 5 4 7 7 4 4 7 7 4 4 4 4 2 2
2 2 0 0 0 0 0 0 0 0 0 0 0 0 0 0 0 3 0 3 1 1 0 3 0 3 0 3 0 0 0 0 0 0 0 0 0 0 0 0 0 0 0 0 0 0 0 0 2 2 2 2 4 4 4 4 4 4 4 4 4 4 4 4 4 4 4 4 4 4 5 5 4 4 4 4 4 4 4 4 4 4 4 5 6 5 4 4 4 4 4 4 4 4 4 4 4 4 2 2
2 2 0 0 0 0 0 0 0 0 0 0 0 0 0 0 0 0 3 0 1 1 3 0 3 0 3 0 0 0 0 0 0 0 0 0 0 0 0 0 0 0 0 0 0 0 0 0 2 2 2 2 4 4 4 4 4 4 4 4 4 4 4 4 4 4 4 4 4 4 5 5 4 4 4 4 4 4 4 4 4 4 4 4 5 4 4 4 4 4 4 4 4 4 4 4 4 4 2 2
2 2 0 0 0 0 0 0 0 0 0 0 0 0 0 0 0 0 0 0 0 1 1 0 0 0 0 0 0 0 0 0 0 0 0 0 0 0 0 0 0 0 0 0 0 0 0 0 2 2 2 2 4 4 4 4 4 4 4 4 4 4 4 4 4 4 4 4 4 4 5 5 4 4 4 4 4 4 4 4 4 4 4 4 4 4 4 4 4 4 4 4 4 4 4 4 4 4 2 2
2 2 0 0 0 0 0 0 0 0 0 0 0 0 0 0 0 0 0 0 0 1 1 0 0 0 0 0 0 0 0 0 0 0 0 0 0 0 0 0 0 0 0 0 0 0 0 0 2 2 2 2 4 4 4 4 4 4 4 4 4 4 4 4 4 4 4 4 4 4 5 5 4 4 4 4 4 4 4 4 4 4 4 4 4 4 4 4 4 4 4 4 4 4 4 4 4 4 2 2
2 2 0 0 0 0 2 2 0 0 0 2 2 0 0 0 2 2 0 0 0 1 1 0 0 0 2 2 0 0 0 3 2 0 3 0 2 3 0 0 3 2 2 3 0 0 0 0 2 2 2 2 4 4 4 4 4 7 4 4 7 4 4 7 4 4 7 4 4 7 5 5 7 4 4 7 4 4 7 4 4 7 4 4 7 4 4 7 4 4 7 4 4 7 4 4 4 4 2 2
2 2 0 0 0 0 0 0 0 0 0 0 0 0 0 0 0 0 0 0 0 0 1 1 0 0 0 0 0 0 3 0 0 3 0 0 3 0 0 3 0 0 3 0 0 0 0 0 2 2 2 2 4 4 4 5 7 7 5 4 7 5 4 4 5 7 4 5 7 7 5 5 7 5 4 4 5 7 4 5 7 7 5 4 7 5 4 4 5 7 4 5 7 7 5 4 4 4 2 2
2 2 2 0 0 0 0 0 0 0 0 0 0 0 0 0 0 0 0 0 0 0 1 1 0 0 0 0 0 0 0 0 3 0 0 3 0 0 3 0 0 3 0 0 3 0 0 0 2 2 2 2 4 4 4 4 4 4 4 4 4 4 4 4 4 4 4 4 4 4 5 5 4 4 4 4 4 4 4 4 4 4 4 4 4 4 4 4 4 4 4 4 4 4 4 4 4 4 2 2
2 2 0 0 0 0 0 0 0 0 0 0 0 0 0 0 0 0 0 0 0 0 1 1 0 0 0 0 0 0 0 3 0 0 3 0 0 3 0 0 3 0 0 3 0 0 0 0 2 2 2 2 4 4 4 4 4 4 4 4 4 4 4 4 4 4 4 4 4 4 5 5 4 4 4 4 4 4 4 4 4 4 4 4 4 4 4 4 4 4 4 4 4 4 4 4 4 4 2 2
2 2 0 0 0 0 0 0 0 0 0 0 0 0 0 0 0 0 0 0 0 0 0 1 1 0 0 0 0 0 3 0 0 3 0 0 3 0 0 3 0 0 3 0 0 0 0 0 2 2 2 2 4 4 4 4 4 4 4 4 4 4 4 4 4 4 4 4 4 4 5 5 4 4 4 4 4 4 4 4 4 4 4 4 4 4 4 4 4 4 4 4 4 4 4 4 4 4 2 2
2 2 0 0 1 0 2 2 0 0 0 2 2 0 0 0 2 2 0 0 0 2 2 1 1 0 2 2 0 0 0 2 3 0 0 3 2 2 3 0 0 3 2 0 3 0 0 0 2 2 2 2 4 4 4 4 4 4 4 4 4 4 4 4 4 4 4 4 4 4 5 5 4 4 4 4 4 4 4 4 4 4 4 4 4 4 4 4 4 4 4 4 4 4 4 4 4 4 2 2
2 2 0 0 1 0 0 0 0 0 0 0 0 0 0 0 0 0 0 0 0 0 0 1 1 0 0 0 0 0 0 3 0 0 3 0 0 3 0 0 3 0 0 3 0 0 0 0 2 2 2 2 4 4 4 4 4 4 4 4 4 4 4 4 4 4 4 4 4 4 5 5 4 4 4 4 4 4 4 4 4 4 4 4 4 4 4 4 4 4 4 4 4 4 4 4 4 4 2 2
2 2 0 0 0 0 0 0 0 0 0 0 0 0 0 0 0 0 0 0 0 0 0 0 1 1 0 0 0 0 3 0 0 3 0 0 3 0 0 3 0 0 3 0 0 0 0 0 2 2 2 2 4 4 4 4 7 7 4 4 7 7 4 4 7 7 4 4 7 7 5 5 7 7 4 4 7 7 4 4 7 7 4 4 7 7 4 4 7 7 4 4 7 7 4 4 4 4 2 2
2 2 0 0 0 0 0 0 0 0 0 0 0 0 0 0 0 0 0 0 0 0 0 0 1 1 0 0 0 0 0 0 3 0 0 3 0 0 3 0 0 3 0 0 3 0 0 0 2 2 2 2 4 4 4 4 4 4 4 4 4 4 4 4 4 4 4 4 4 4 5 5 4 4 4 4 4 4 4 4 4 4 4 4 4 4 4 4 4 4 4 4 4 4 4 4 4 4 2 2
2 2 0 0 0 0 0 0 0 0 0 0 0 0 0 0 0 0 0 0 0 0 0 0 1 1 0 0 0 0 0 3 0 0 3 0 0 3 0 0 3 0 0 3 0 0 0 0 2 2 2 2 4 4 4 4 4 4 4 4 4 4 4 4 4 4 4 4 4 4 5 5 4 4 4 4 4 4 4 4 4 4 4 4 4 4 4 4 4 4 4 4 4 4 4 4 4 4 2 2
2 2 0 0 0 0 0 0 0 0 0 0 0 0 0 0 0 0 0 0 0 0 0 0 0 0 0 0 0 0 0 0 0 0 0 0 0 0 0 0 0 0 0 0 0 0 0 0 2 2 2 2 4 4 4 4 4 4 4 4 4 4 4 4 4 4 4 4 4 4 4 4 4 4 4 4 4 4 4 4 4 4 4 4 4 4 4 4 4 4 4 4 4 4 4 4 4 4 2 2
2 2 0 0 0 0 0 0 0 0 0 0 0 0 0 0 0 0 0 0 0 0 0 0 0 0 0 0 0 0 0 0 0 0 0 0 0 0 0 0 0 0 0 0 0 0 0 0 2 2 2 2 4 4 4 4 4 4 4 4 4 4 4 4 4 4 4 4 4 4 4 4 4 4 4 4 4 4 4 4 4 4 4 4 4 4 4 4 4 4 4 4 4 4 4 4 4 4 2 2
2 2 0 0 0 0 0 0 0 0 0 0 0 0 0 0 0 0 0 0 0 0 0 0 0 0 0 0 0 0 0 0 0 0 0 0 0 0 0 0 0 0 0 0 0 0 0 0 2 2 2 2 4 4 4 4 4 4 5 4 4 4 4 4 4 4 4 5 4 4 4 4 4 4 4 4 5 4 4 4 4 4 4 4 4 5 4 4 4 4 4 4 4 4 5 4 4 4 2 2
2 2 2 2 2 2 2 2 2 2 2 2 2 2 2 2 2 2 2 2 2 2 2 2 2 2 2 2 2 2 2 2 2 2 2 2 2 2 2 2 2 2 2 2 2 2 2 2 2 2 2 2 2 2 2 2 2 2 2 2 2 2 2 2 2 2 2 2 2 2 2 2 2 2 2 2 2 2 2 2 2 2 2 2 2 2 2 2 2 2 2 2 2 2 2 2 2 2 2 2
2 2 2 2 2 2 2 2 2 2 2 2 2 2 2 2 2 2 2 2 2 2 2 2 2 2 2 2 2 2 2 2 2 2 2 2 2 2 2 2 2 2 2 2 2 2 2 2 2 2 2 2 2 2 2 2 2 2 2 2 2 2 2 2 2 2 2 2 2 2 2 2 2 2 2 2 2 2 2 2 2 2 2 2 2 2 2 2 2 2 2 2 2 2 2 2 2 2 2 2
2 2 2 2 2 2 2 2 2 2 2 2 2 2 2 2 2 2 2 2 2 2 2 2 2 2 2 2 2 2 2 2 2 2 2 2 2 2 2 2 2 2 2 2 2 2 2 2 2 2 2 2 2 2 2 2 2 2 2 2 2 2 2 2 2 2 2 2 2 2 2 2 2 2 2 2 2 2 2 2 2 2 2 2 2 2 2 2 2 2 2 2 2 2 2 2 2 2 2 2
2 2 2 2 2 2 2 2 2 2 2 2 2 2 2 2 2 2 2 2 2 2 2 2 2 2 2 2 2 2 2 2 2 2 2 2 2 2 2 2 2 2 2 2 2 2 2 2 2 2 2 2 2 2 2 2 2 2 2 2 2 2 2 2 2 2 2 2 2 2 2 2 2 2 2 2 2 2 2 2 2 2 2 2 2 2 2 2 2 2 2 2 2 2 2 2 2 2 2 2
2 2 8 8 8 8 8 A 8 8 8 8 8 8 8 8 8 8 8 A 8 8 8 8 8 8 8 8 8 8 8 A 8 8 8 8 8 8 8 8 8 8 8 A 8 8 8 8 2 2 2 2 C C C C C C C C C C C C C C C C C C C C C C C C C C C C C C C C C C C C C C C C C C C C C C 2 2
2 2 8 8 8 8 8 8 8 8 8 8 8 8 8 8 8 8 8 8 8 8 8 8 8 8 8 8 8 8 8 8 8 8 8 8 8 8 8 8 8 8 8 8 8 8 8 8 2 2 2 2 C C C C C C C C C C C C C C C C C C C C C C C C C C C C C C C C C C C C C C C C C C C C C C 2 2
2 2 8 8 8 8 8 8 8 8 8 8 8 8 8 8 8 8 8 8 8 8 8 8 8 8 8 8 8 8 8 8 8 8 8 8 8 8 8 8 8 8 8 8 8 8 8 8 2 2 2 2 C C C C C C C C C C C C C C C C C C C C C C C C C C C C C C C C C C C C C C C C C C C C C C 2 2
2 2 8 8 8 8 B 8 A B 8 8 B 8 8 B 8 8 B 8 8 B A 8 B 8 8 B 8 A 9 8 8 B 8 8 B 8 8 B 8 8 B A 8 8 8 8 2 2 2 2 C C C C C C C C C C C C C D C C C C C C C C C C C C C C C C C C C C C C C C C C C C C C C C 2 2
2 2 8 8 8 8 8 A 8 8 8 8 8 8 A 8 8 8 8 8 8 A 8 8 8 8 8 8 A 8 9 8 8 8 8 A 8 8 8 8 8 8 A 8 8 8 8 8 2 2 2 2 C C C C D C C C C C C C D E C C C C C C D C C C C C C C D C C C C C C C D C C C C C C C C C 2 2
2 2 8 8 8 8 A 8 8 8 8 8 8 A 8 8 8 8 8 8 A 8 8 8 8 8 8 A 8 8 9 8 8 8 A 8 8 8 8 8 8 A 8 8 8 9 8 8 2 2 2 2 C C C C C C C C C C C C C D C C C C C C C C C C C C C C C C C C C C C C C C C C C C C C C C 2 2
2 2 8 8 8 A 8 8 8 8 8 8 A 8 8 8 8 8 8 A 8 8 8 8 8 8 A 8 8 8 9 8 8 A 8 8 8 8 8 8 A 8 8 8 8 9 8 8 2 2 2 2 C C C C C C C C C C C C C E C C C C C C C C C C C C C C C C C C C C C C C C C C C C C C C C 2 2
2 2 8 8 8 8 8 8 8 8 8 A 8 8 8 8 8 8 A 8 8 8 8 8 8 A 8 8 8 9 8 8 A 8 8 8 8 8 8 A 8 8 8 8 8 8 8 8 2 2 2 2 C C C C C C C D E D C C C D C C C C C C C C C C C C C C C C C C C C C C C C C C C C C C C C 2 2
2 2 8 8 8 9 A 9 8 B A 8 B 8 8 B 8 A B 8 8 B 8 8 B 8 8 B 8 9 B A 8 B 8 8 B 8 A B 8 8 B 8 8 8 8 8 2 2 2 2 C C C C C C C E E E C C C C E C C C C C C C C C C C C C C C C C C C C C C C C C C C C C C C 2 2
2 2 8 8 8 8 8 8 A 9 A 8 8 8 8 8 A A A A 8 8 8 A 8 8 8 8 8 9 A 8 8 8 8 8 8 A 8 8 8 8 8 8 A 8 8 8 2 2 2 2 C C C C C C C D E D C C C C D C C C C C C C C C C C C C C C C C C C C C C C C C C C C C C C 2 2
2 2 8 8 8 8 8 8 A 8 8 9 A 9 8 A 8 A B A 8 8 A 8 8 8 8 8 8 9 8 8 8 8 8 8 A 8 8 8 8 8 8 A 8 8 8 8 2 2 2 2 C C C C C C C C C C C C C C E C C C C C C C C C C C C C C C C C C C C C C C C C C C C C C C 2 2
2 2 8 8 8 8 8 A 8 8 8 8 8 8 A 9 A A A A 8 A 8 8 8 8 8 8 9 8 8 8 8 8 8 A 8 8 8 8 8 8 A 8 8 8 8 8 2 2 2 2 C C C C C C C C C C C C C C D C C C C C C C C C C C C C C C C C C C C C C C C C C C C C C C 2 2
2 2 8 8 8 8 A 8 8 8 8 8 8 A 8 8 8 9 A 9 A 8 8 8 8 8 8 A 9 8 8 8 8 8 A 8 8 8 8 8 8 A 8 8 8 8 8 8 2 2 2 2 C C C C D C C C C C C C D C E C C C C C D C C C C C C C D C C C C C C C D C C C C C C C C C 2 2
2 2 8 8 8 A B 8 8 B 8 8 B 8 8 B 8 8 B A A 9 A A 8 A A B 9 8 B 8 8 B 8 8 B 8 8 B A 8 B 8 8 8 8 8 2 2 2 2 C C C C C C C C C C C C C C C D C C C C C C C C C C C C C C C C C C C C C C C C C C C C C C 2 2
2 2 8 8 8 8 8 8 8 8 8 A 8 8 8 8 8 8 A 8 A 8 A 9 A 9 A 8 9 8 8 8 A 8 8 8 8 8 8 A 8 8 8 8 8 8 8 8 2 2 2 2 C C C C C C C C C C C C C C C E C C C C C C C C C C C C C C C C C C C C C C C C C C C C C C 2 2
2 2 8 8 8 8 8 8 8 8 A 8 8 8 8 8 8 A 8 A 8 A 8 A 8 A A 9 A 8 8 A 8 8 8 8 8 8 A 8 8 8 8 8 8 8 8 8 2 2 2 2 C C C C C C C C C C C C C C C D C C C C C C C C C C C C C C C C C C C D E D C C C C C C C C 2 2
2 2 8 8 8 8 8 8 8 A 8 8 8 8 8 8 A 8 A 9 9 9 9 9 9 9 A 9 A 9 A 9 8 8 8 8 8 A 8 8 8 8 8 8 A 8 8 8 2 2 2 2 C C C C C C C C C C C C C C C E C C C C C C C C C C C C C C C C C C C E E E C C C C C C C C 2 2
2 2 8 8 8 8 8 8 A 8 8 A A A 8 A 8 A 9 9 9 9 9 9 9 9 9 9 8 A 8 8 A 9 A 8 A 8 8 8 8 8 8 A 8 8 8 8 2 2 2 2 C C C C C C C C C C C C C C C D C C C C C C C C C C C C C C C C C C C D E D C C C C C C C C 2 2
2 2 8 8 8 8 B A 8 B 8 A B A A 8 A 9 9 9 9 9 9 9 9 9 9 9 A 8 A 8 8 B 8 9 A 9 8 B 8 8 B 8 8 9 8 8 2 2 2 2 C C C C C C C C C C C C C C C C E C C C C C C C C C C C C C C C C C C C C C C C C C C C C C 2 2
2 2 8 8 8 8 A 8 8 8 8 A A A 8 A 9 9 9 9 9 9 9 9 9 9 9 9 9 A 8 A 8 8 A 8 8 8 A 9 A A 8 8 8 9 8 8 2 2 2 2 C C C C D C D C D C D C C C C C D C C C C C C C C C C C C C C C C C C C C C C C C C C C C C 2 2
2 2 8 8 8 A 8 8 8 8 8 8 A 8 A 9 9 9 9 9 9 9 9 9 9 9 9 9 9 9 A 8 A A 8 8 8 8 8 8 A 9 A 9 8 8 8 8 2 2 2 2 C C C C C D F G H D C D D C C C E C C C D C C C C C C C D C C C C C C C D C C C C C C C C C 2 2
2 2 8 8 8 8 8 8 8 8 8 A 8 A 8 9 9 9 9 9 9 9 9 9 9 9 9 9 9 9 8 A 8 8 8 8 8 8 8 A 8 8 8 8 A 8 8 8 2 2 2 2 C C C C D C I J K C D C C C C C D C C C C C C C C C C C C C C C C C C C C C C C C C C C C C 2 2
2 2 8 8 8 8 8 8 8 8 A 8 A 8 A 9 9 9 9 9 9 9 9 9 9 9 9 9 9 9 A 8 A 8 8 8 8 8 A 8 8 8 8 8 8 8 8 8 2 2 2 2 C C C C C D C D C D C D C C C C E C C C C C C C C C C C C C C C C C C C C C C C C C C C C C 2 2
2 2 8 8 8 8 B 8 8 B 8 8 8 A 8 9 9 9 9 9 9 9 9 9 9 9 9 9 9 9 8 A 8 B 8 8 B A 8 B 8 8 B 8 A 8 8 8 2 2 2 2 C C C C D C D C D C D C C C C C C D C C C C C C C C C C C C C C C C C C C C C C C C C C C C 2 2
2 2 8 8 8 8 8 8 A 8 8 8 A 8 A 9 9 9 9 9 9 9 9 9 9 9 9 9 9 9 A 8 A 8 8 8 A 8 8 8 8 8 8 A 8 8 8 8 2 2 2 2 C C C C C D C D C D C D C C C C C E C C C C C C C C C C C C C C C C C C C C C C C C C C C C 2 2
2 2 8 8 8 8 8 A 8 8 8 8 8 A 8 9 9 9 9 9 9 9 9 9 9 9 9 9 9 9 8 A 8 8 8 A 8 8 8 8 8 8 A 8 8 8 8 8 2 2 2 2 C C C C C C C C C C C C C C C C C D C C C C C C C C C C C C C C C C C C C C C C C C C C C C 2 2
2 2 8 8 8 8 A 8 8 8 8 8 A 8 A 9 9 9 9 9 9 9 9 9 9 9 9 9 9 9 A 8 A 8 A 8 8 8 8 8 8 A 8 8 8 8 8 8 2 2 2 2 C C C C C C C C C C C C C C C C C E C C C C C C C C C C C C C C C C C C C C C C C C C C C C 2 2
2 2 8 8 8 A 8 8 8 8 8 8 A A 8 A 9 9 9 9 9 9 9 9 9 9 9 9 9 A 8 A 8 A 8 8 8 8 8 8 A 8 8 8 8 8 8 8 2 2 2 2 C C C C C C C C C C C C C C C C C D C C C C C C C C C D E D C C C C C C C C C C C C C C C C 2 2
2 2 8 8 8 8 B 8 8 B 8 A B 8 A 8 A 9 9 9 9 9 9 9 9 9 9 9 A 8 A 8 A B 8 8 B 8 8 B 8 8 B 8 8 8 8 8 2 2 2 2 C C C C D C C C C C C C D C C C C C E C D C C C C C C E E E C C C C C C D C C C C C C C C C 2 2
2 2 8 8 8 8 8 8 8 8 A 8 8 8 8 A 8 A 9 9 9 9 9 9 9 9 9 A A A 8 A 8 8 8 8 8 8 A 8 8 8 8 8 8 8 8 8 2 2 2 2 C C C C C C C C C C C C C C C C C C D C C C C C C C C D E D C C C C C C C C C C C C C C C C 2 2
2 2 8 8 8 8 8 8 8 A 8 8 8 8 8 8 A 8 A 9 9 9 9 9 9 9 A A B A A 8 8 8 8 8 8 A 8 8 8 8 8 8 A 8 8 8 2 2 2 2 C C C C C C C C C C C C C C C C C C E C C C C C C C C C C C C C C C C C C C C C C C C C C C 2 2
2 2 8 8 8 8 8 8 A 8 8 8 8 8 8 A 8 A 8 A 8 A 8 9 8 A 8 A A A 8 8 8 8 8 8 A 8 8 8 8 8 8 A 8 9 8 8 2 2 2 2 C C C C C C C C C C C C C C C C C C D C C C C C C C C C C C C C C C C C C C C C C C C C C C 2 2
2 2 8 8 8 8 8 A 8 8 8 8 8 8 A 8 8 8 A 8 A 8 A 9 A 8 A 8 A 8 8 8 8 8 8 A 8 8 8 8 8 8 A 8 8 9 8 8 2 2 2 2 C C C C C C C C C C C C C C C C C C E C C C C C C C C C C C C C C C C C C C C C C C C C C C 2 2
2 2 8 8 8 8 B 8 8 B 8 8 B A 8 B 8 8 B A 8 A 8 9 8 A 8 B 8 8 B 8 8 B A 8 B 8 8 B 8 A B 8 8 8 8 8 2 2 2 2 C C C C C C C C C C C C C C C C C C C D C C C C C C C C C C C C C C C C C C C C C C C C C C 2 2
2 2 8 8 8 A 8 8 8 8 8 8 A 8 8 8 8 8 8 A 8 8 8 9 8 8 A 8 8 8 8 8 8 A 8 8 8 8 8 8 A 8 8 8 8 8 8 8 2 2 2 2 C C C C C C C C C C C C C C C C C C C E C C C C C C C C C C C C C C C C C C C C C C C C C C 2 2
2 2 8 8 8 8 8 8 8 8 8 A 8 8 8 8 8 8 A 8 8 8 9 8 8 A 8 8 8 8 8 8 A 8 8 8 8 8 8 A 8 8 8 8 8 8 8 8 2 2 2 2 C C C C C C C C C C C C C C C C C C C D C C C C C C C C C C C C C C C C C C C C C C C C C C 2 2
2 2 8 8 8 8 8 8 8 8 A 8 8 8 8 8 8 A 8 8 8 8 9 8 A 8 8 8 8 8 8 A 8 8 8 8 8 8 A 8 8 8 8 8 8 8 8 8 2 2 2 2 C C C C D C C C C C C C D C C C C C C E D C C C C C C C D C C C C C C C D C C C C C C C C C 2 2
2 2 8 8 8 8 8 8 8 A 8 8 8 8 8 8 A 8 8 8 8 8 9 A 8 8 8 8 8 8 A 8 8 8 8 8 8 A 8 8 8 8 8 8 A 8 8 8 2 2 2 2 C C C C C C C C C C C C C C C C C C C D C C C C C C C C C C C C C C C C C C C C C C C C C C 2 2
2 2 8 8 8 8 B 8 A B 8 8 B 8 8 B 8 8 B 8 8 B 9 8 B 8 8 B 8 A B 8 8 B 8 8 B 8 8 B 8 8 B A 8 8 8 8 2 2 2 2 C C C C C C C C C C C C C C C C C C C C E C C C C C C C C C C C C C C C C C C C C C C C C C 2 2
2 2 8 8 8 8 8 A 8 8 8 8 8 8 A 8 8 8 8 8 8 9 8 8 8 8 8 8 A 8 8 8 8 8 8 A 8 8 8 8 8 8 A 8 8 8 8 8 2 2 2 2 C C C C C C C C C C C C C C C C C C C C D C C C C C C C C C C C C C C C C C C C C C C C C C 2 2
2 2 8 8 8 8 A 8 8 8 8 8 8 A 8 8 8 8 8 8 A 9 8 8 8 8 8 A 8 8 8 8 8 8 A 8 8 8 8 8 8 A 8 8 8 8 8 8 2 2 2 2 C C C C C C C C C C C C C C C C C C C C E C C C C C C C C C C C C C C C C C C C C C C C C C 2 2
2 2 8 8 8 A 8 8 8 8 8 8 A 8 8 8 8 8 8 A 8 9 8 8 8 8 A 8 8 8 8 8 8 A 8 8 8 8 8 8 A 8 8 8 8 8 8 8 2 2 2 2 C C C C C C C C C C C C C C C C C C C C D C C C C C C C C C C C C C C C C C C C C C C C C C 2 2
2 2 8 8 8 8 8 8 8 8 8 A 8 8 8 8 8 8 A 8 8 9 8 8 8 A 8 8 8 8 8 8 A 8 8 8 8 8 8 A 8 8 8 8 8 8 8 8 2 2 2 2 C C C C C C C C C C C C C C C C C C C C E C C C C C C C C C C C C C C C C C C C C C C C C C 2 2
2 2 8 8 8 8 8 8 8 8 8 8 8 8 8 8 8 8 8 8 8 8 8 8 8 8 8 8 8 8 8 8 8 8 8 8 8 8 8 8 8 8 8 8 8 8 8 8 2 2 2 2 C C C C C C C C C C C C C C C C C C C C C C C C C C C C C C C C C C C C C C C C C C C C C C 2 2
2 2 8 8 8 9 9 8 8 8 8 8 8 8 8 8 8 8 9 9 8 8 8 8 8 8 8 8 8 8 8 9 9 8 8 8 8 8 8 8 8 8 8 8 9 9 8 8 2 2 2 2 C C C C C C C C C C C C C C C C C C C C C C C C C C C C C C C C C C C C C C C C C C C C C C 2 2
2 2 8 8 8 9 9 8 8 8 8 8 8 8 8 8 8 8 9 9 8 8 8 8 8 8 8 8 8 8 8 9 9 8 8 8 8 8 8 8 8 8 8 8 9 9 8 8 2 2 2 2 C C C C C C C C C C C C C C C C C C C C C C C C C C C C C C C C C C C C C C C C C C C C C C 2 2
2 2 2 2 2 2 2 2 2 2 2 2 2 2 2 2 2 2 2 2 2 2 2 2 2 2 2 2 2 2 2 2 2 2 2 2 2 2 2 2 2 2 2 2 2 2 2 2 2 2 2 2 2 2 2 2 2 2 2 2 2 2 2 2 2 2 2 2 2 2 2 2 2 2 2 2 2 2 2 2 2 2 2 2 2 2 2 2 2 2 2 2 2 2 2 2 2 2 2 2
2 2 2 2 2 2 2 2 2 2 2 2 2 2 2 2 2 2 2 2 2 2 2 2 2 2 2 2 2 2 2 2 2 2 2 2 2 2 2 2 2 2 2 2 2 2 2 2 2 2 2 2 2 2 2 2 2 2 2 2 2 2 2 2 2 2 2 2 2 2 2 2 2 2 2 2 2 2 2 2 2 2 2 2 2 2 2 2 2 2 2 2 2 2 2 2 2 2 2 2
