20 15
1 1 1 1 1 1 1 1 1 1 1 1 1 1 1 1 1 1 1 1
1 2 2 2 2 2 2 2 2 2 2 2 2 2 2 2 2 2 2 1
1 2 1 1 1 2 2 2 2 2 2 2 2 2 1 1 1 2 2 1
1 2 1 0 1 2 3 3 3 3 3 3 3 2 1 0 1 2 2 1
1 2 1 1 1 2 3 3 3 3 3 3 3 2 1 1 1 2 2 1
1 2 2 2 2 2 2 2 2 2 2 2 2 2 2 2 2 2 2 1
1 2 2 2 2 2 2 2 2 2 2 2 2 2 2 2 2 2 2 1
1 2 1 1 1 2 2 2 2 2 2 2 2 2 1 1 1 2 2 1
1 2 1 0 1 2 2 2 2 2 2 2 2 2 1 0 1 2 2 1
1 2 1 1 1 2 3 3 3 3 3 3 3 2 1 1 1 2 2 1
1 2 2 2 2 2 3 3 3 3 3 3 3 2 2 2 2 2 2 1
1 2 2 2 2 2 2 2 2 2 2 2 2 2 2 2 2 2 2 1
1 2 2 2 2 2 2 2 2 2 2 2 2 2 2 2 2 2 2 1
1 2 2 2 2 2 2 2 2 2 2 2 2 2 2 2 2 2 2 1
1 1 1 1 1 1 1 1 1 1 1 1 1 1 1 1 1 1 1 1
R 5 7 1 2
R 10 10 2 1
