100 100
12 12 12 12 12 12 12 12 12 12 12 12 2 12 12 12 12 12 12 12 12 12 12 12 12 12 12 12 12 12 12 12 12 12 12 12 12 12 12 2 12 12 12 12 12 12 12 12 12 12 12 12 12 12 12 12 12 12 4 12 12 12 12 12 12 12 12 4 12 12 4 12 12 4 4 6 4 12 12 12 12 4 4 12 12 12 12 12 12 12 12 12 12 12 12 12 12 12 12 12
12 12 12 12 12 12 12 12 12 12 12 12 12 12 12 12 12 12 12 12 12 12 2 2 12 12 12 12 12 12 12 12 12 12 12 12 12 12 12 12 12 12 12 12 12 12 12 12 12 12 12 12 12 12 12 12 12 12 12 4 12 4 12 4 4 12 4 4 12 12 4 4 4 12 4 4 12 12 12 4 4 12 4 4 4 12 12 12 12 12 12 12 12 12 12 12 12 12 12 12
12 12 2 12 12 12 12 12 12 12 12 12 12 12 12 12 12 12 12 12 12 2 12 12 12 12 12 12 12 12 12 12 12 12 12 12 12 12 12 12 12 12 12 12 12 12 12 12 12 12 12 12 12 12 12 12 12 12 12 12 12 12 4 4 4 4 6 4 4 4 4 4 6 4 6 4 4 4 4 4 4 4 4 12 12 4 12 12 12 4 12 12 12 12 12 12 12 12 12 12
12 12 12 12 12 12 12 2 12 12 12 12 12 12 12 12 12 12 12 12 2 12 12 2 12 12 2 0 2 12 2 12 12 12 12 2 12 12 2 12 12 12 12 12 12 12 12 12 12 12 12 12 12 12 12 12 6 12 4 4 4 4 4 6 4 4 4 4 4 4 4 4 4 4 6 6 4 4 4 4 4 4 4 4 4 4 6 12 4 12 12 12 12 12 12 12 12 12 12 12
12 12 12 12 12 12 2 12 12 12 12 12 12 12 12 12 12 12 2 12 12 12 12 0 12 0 0 0 2 0 12 12 12 0 12 12 12 2 12 12 12 12 12 12 12 12 12 12 12 12 12 12 12 12 12 4 12 4 4 4 4 4 4 4 4 4 6 4 4 4 4 4 4 6 6 6 6 4 4 6 4 4 4 4 4 4 12 4 12 12 6 12 12 12 12 12 12 12 12 12
12 12 12 2 12 12 12 12 12 12 12 12 2 12 12 0 2 0 0 0 0 12 2 12 12 2 12 0 12 12 0 0 12 2 0 0 12 2 12 12 12 12 12 12 12 12 12 12 12 12 12 6 12 12 12 4 12 4 4 4 4 4 4 4 6 6 6 6 6 4 4 4 6 6 6 5 6 6 4 4 4 4 4 4 4 4 4 4 4 4 12 12 12 12 12 12 12 12 12 12
12 12 12 12 12 12 12 12 12 12 2 12 12 2 12 12 0 2 0 0 2 0 2 12 2 0 0 0 0 12 2 0 12 12 12 0 0 12 12 12 12 12 12 12 12 12 12 12 12 12 12 12 4 6 4 4 6 4 4 4 4 4 4 6 5 5 5 5 5 6 6 6 6 6 6 6 6 4 6 7 4 4 4 6 4 4 4 6 4 12 4 12 12 12 12 12 12 12 12 12
12 12 12 12 12 12 12 12 12 0 12 0 0 12 12 0 12 0 0 0 12 2 2 0 0 2 2 0 0 2 0 2 0 0 2 12 0 2 12 12 2 12 12 12 12 12 12 12 12 12 4 12 4 12 4 4 4 12 4 4 4 4 4 6 5 5 5 5 5 6 5 5 5 5 5 6 6 6 6 6 6 4 4 4 4 6 4 4 4 6 12 4 4 6 4 12 12 12 12 12
12 12 12 12 12 12 12 12 12 12 12 12 0 2 2 0 12 0 0 0 0 0 2 0 0 1 2 0 0 2 0 0 12 0 0 0 2 2 0 0 12 12 12 12 12 12 12 12 12 12 12 12 12 4 4 4 4 4 4 4 4 4 6 6 5 5 5 5 5 6 6 5 5 5 5 6 6 6 5 5 6 4 4 6 6 6 6 6 4 4 4 4 6 6 6 12 4 12 12 12
12 12 12 12 12 12 12 12 0 12 0 0 0 2 2 0 2 0 2 0 0 2 2 2 2 0 0 0 2 0 0 2 0 0 0 2 2 12 0 12 2 12 0 12 12 0 12 12 12 12 12 4 12 12 6 4 4 4 4 6 6 4 6 6 5 5 5 5 5 6 5 5 5 5 5 6 6 6 6 6 6 6 6 5 5 5 5 5 6 4 4 6 6 5 6 6 12 12 12 12
12 12 12 12 12 12 12 12 0 12 2 12 0 0 0 0 0 2 1 0 0 0 2 2 2 0 0 2 0 0 0 0 0 0 0 2 0 3 0 2 0 0 2 12 2 12 12 12 12 12 4 4 4 4 4 4 4 4 4 4 7 6 6 6 5 5 5 5 5 6 5 5 5 5 5 6 5 5 5 5 6 4 6 5 5 5 5 5 6 6 4 4 6 6 6 4 12 4 12 12
12 12 12 12 12 0 12 12 12 0 0 12 13 2 2 0 0 0 0 3 0 0 0 3 0 0 0 2 0 0 0 0 2 1 0 0 0 0 0 0 2 0 2 12 12 12 12 4 4 12 12 12 4 4 4 4 4 4 6 4 6 6 6 5 6 6 6 6 6 6 5 5 5 5 5 6 5 5 5 5 6 6 6 5 5 5 5 5 6 6 4 4 4 6 4 4 4 12 12 4
12 12 12 12 12 0 12 12 2 12 0 3 0 2 0 0 0 2 0 0 0 1 1 0 0 0 0 2 0 2 1 3 0 0 0 2 0 0 0 0 0 3 0 12 12 12 12 12 12 12 4 4 4 4 4 4 4 4 4 6 6 5 6 6 5 5 6 5 6 6 6 6 6 6 6 5 5 5 5 5 6 6 6 5 5 5 5 5 6 4 4 6 4 4 4 12 4 4 6 12
12 12 12 12 0 0 12 12 0 2 0 0 0 0 0 0 0 0 2 0 0 0 0 0 3 0 3 0 1 0 2 1 0 0 0 0 0 2 0 0 3 0 0 12 12 0 0 12 4 4 4 4 4 4 4 4 4 7 6 4 6 6 6 6 6 6 6 6 6 6 6 4 6 6 6 5 5 5 5 5 6 4 6 5 5 5 5 5 6 4 4 4 4 4 4 4 6 12 12 12
12 12 12 12 12 0 2 2 12 0 0 0 0 0 0 0 0 0 1 0 2 0 0 0 0 1 0 0 0 1 3 0 0 0 0 2 2 3 0 0 0 0 0 3 2 12 12 0 4 12 4 4 4 4 4 4 6 6 6 6 6 6 6 5 5 6 5 5 6 5 6 6 4 5 6 5 5 5 5 5 6 5 5 6 6 6 6 6 4 4 4 6 4 4 4 12 12 4 12 12
12 12 12 12 12 12 2 0 2 0 0 2 2 0 0 2 0 2 0 0 0 2 0 2 0 0 2 2 2 0 0 3 0 2 0 0 0 1 1 0 0 2 0 2 2 12 4 12 0 12 4 4 4 4 4 6 5 5 6 5 5 6 6 6 6 5 5 5 6 6 6 4 5 6 6 6 6 6 6 6 4 5 4 4 4 6 4 4 4 4 4 4 4 4 4 4 4 12 12 4
12 0 12 12 2 2 2 0 0 0 2 0 2 0 1 0 3 0 0 2 2 3 0 0 2 0 0 0 0 1 0 2 0 0 2 1 2 3 2 0 1 2 0 2 2 0 12 12 0 12 4 4 4 4 4 6 5 6 6 6 5 6 6 6 6 6 5 5 6 6 6 4 4 4 7 6 6 6 6 6 6 4 4 4 4 4 4 4 4 5 6 4 4 4 4 4 4 4 12 4
12 0 12 12 0 0 0 2 2 2 2 3 0 0 1 0 0 0 0 0 0 3 0 2 0 0 0 2 1 2 0 2 0 0 1 2 0 0 2 0 0 0 0 3 2 0 12 2 12 12 4 4 7 4 6 6 6 6 5 6 6 6 6 5 5 6 5 5 6 6 6 6 6 5 4 6 5 5 5 6 4 4 4 4 4 4 4 4 6 6 6 6 6 4 4 4 4 4 4 4
12 12 2 2 12 2 0 2 0 2 0 3 3 0 2 0 0 0 2 1 0 2 0 0 2 1 0 0 0 2 0 0 3 0 3 0 2 0 0 3 0 1 0 0 0 12 12 4 12 4 4 4 4 4 4 6 5 6 6 6 5 6 5 5 5 6 6 6 5 5 6 5 5 6 6 6 5 5 5 6 6 6 4 12 12 12 12 6 6 6 6 6 6 6 4 4 4 12 12 12
12 12 12 0 0 0 2 0 0 0 2 1 0 2 1 2 1 2 2 2 0 0 2 0 1 2 0 0 0 0 2 0 2 0 0 0 0 0 0 0 0 0 2 0 12 12 12 12 4 4 4 4 5 4 4 6 5 5 6 5 5 6 5 5 5 6 6 6 6 6 6 6 6 6 5 6 5 5 5 6 6 4 12 12 12 12 12 6 6 5 5 5 6 6 4 4 4 4 4 12
12 12 0 0 2 0 2 2 2 0 2 0 2 0 0 0 0 1 0 0 0 0 0 0 0 2 0 0 2 0 0 1 0 2 3 0 2 0 0 1 0 1 2 0 0 2 12 12 12 4 4 4 4 4 6 6 6 6 6 6 6 6 6 6 6 6 6 6 6 5 5 5 6 6 6 6 6 6 6 6 6 6 12 12 12 12 6 6 6 5 5 5 6 6 6 4 4 6 12 12
12 0 12 0 2 0 0 2 0 0 0 0 0 1 0 0 3 2 0 0 1 0 1 0 0 0 0 1 0 2 0 1 0 0 0 0 2 0 2 0 0 0 2 0 0 0 0 0 0 4 4 4 4 6 6 6 6 6 6 4 4 4 5 6 5 5 5 6 6 5 5 5 6 6 4 4 6 6 6 6 5 6 6 12 12 12 6 5 6 5 5 5 6 5 5 6 4 4 4 12
12 0 0 12 0 2 2 2 0 0 1 0 0 0 0 0 2 3 0 0 1 3 3 1 0 0 1 2 0 0 0 0 1 0 0 1 0 2 2 0 3 0 3 2 0 0 0 12 12 12 4 4 4 6 5 5 5 6 4 4 4 4 6 6 5 5 5 6 6 5 5 5 6 6 6 6 6 6 6 6 6 6 12 12 12 6 6 5 6 6 6 6 6 6 5 6 4 4 12 12
12 0 2 2 0 2 0 2 2 2 2 2 0 0 0 0 0 2 0 0 0 1 2 0 0 0 0 1 0 0 3 0 0 0 0 1 1 0 0 0 1 3 2 0 0 2 0 12 12 12 4 4 6 6 5 5 5 6 6 5 4 4 4 6 5 5 5 6 6 6 6 6 6 6 6 5 5 5 6 6 6 12 12 12 12 12 6 5 5 5 6 5 6 5 5 6 6 4 4 4
12 2 2 2 0 0 2 0 0 1 0 0 0 0 0 0 1 0 0 0 2 0 1 1 0 0 0 1 0 1 0 0 3 0 0 1 0 0 0 2 3 2 0 0 2 0 0 12 0 12 4 4 4 6 5 5 6 6 4 6 4 5 5 6 6 6 6 6 5 4 6 4 6 6 6 6 5 6 6 5 6 6 12 12 12 12 6 5 5 5 5 5 6 5 5 6 4 4 4 4
2 2 0 0 0 2 1 0 0 0 3 0 2 0 2 0 0 2 0 0 0 0 0 0 3 0 0 0 0 0 2 0 1 0 0 0 2 0 3 2 0 0 0 2 1 12 12 12 12 12 4 4 4 6 6 6 6 6 6 6 6 6 7 4 5 6 4 4 5 4 4 6 4 5 6 6 6 5 6 6 6 12 12 12 12 4 6 6 6 6 6 6 5 5 5 6 4 4 4 6
0 2 0 0 0 0 0 0 0 0 0 1 0 2 2 0 0 2 1 3 1 2 0 0 2 1 2 2 2 3 0 0 0 0 0 0 0 2 0 2 2 0 0 0 2 0 12 12 12 4 4 4 4 5 6 6 5 6 6 5 5 6 4 5 5 7 4 6 5 6 6 6 6 6 6 5 6 6 6 6 12 12 12 12 12 4 5 6 5 6 6 6 6 6 6 4 4 4 4 12
0 0 2 2 2 0 2 0 0 0 1 0 0 0 3 2 0 1 0 0 0 0 1 0 0 0 0 0 0 0 0 1 1 2 0 0 0 0 0 0 0 2 0 3 2 0 12 4 12 4 6 4 4 7 4 6 6 6 5 5 5 6 6 4 6 4 4 4 5 6 5 6 6 6 6 6 6 12 12 12 12 12 12 12 5 4 4 6 5 5 5 5 6 6 7 4 4 4 4 12
0 0 2 2 0 1 0 1 0 0 0 2 2 1 3 0 2 0 2 1 0 0 0 0 2 0 0 2 1 0 3 0 1 2 2 2 0 0 0 0 1 0 0 1 0 2 12 12 12 12 12 12 12 12 4 4 6 6 5 5 5 6 4 4 4 4 4 5 6 6 6 5 5 5 5 6 6 12 12 12 12 12 12 4 4 6 5 4 6 6 6 6 6 4 4 4 4 4 4 4
0 0 0 0 0 0 0 0 0 0 0 0 1 0 2 0 1 0 0 2 1 0 0 0 0 0 2 0 0 1 2 0 0 0 0 0 2 0 0 1 3 2 0 0 0 2 12 12 12 12 12 12 12 12 4 4 7 6 6 6 6 6 4 4 4 4 7 4 5 6 6 5 5 5 5 5 6 12 12 12 12 12 5 4 4 5 5 4 4 5 6 4 4 4 4 4 4 4 4 4
0 2 0 2 0 0 0 1 0 2 0 3 0 0 0 0 0 1 2 0 2 0 0 0 0 0 0 1 0 0 2 0 0 2 0 0 0 2 3 0 0 0 0 0 1 12 12 12 15 16 16 17 12 12 4 4 4 7 5 6 6 4 4 4 4 4 4 4 5 6 6 5 5 5 5 5 6 6 12 12 12 4 4 4 6 5 4 4 4 4 4 4 4 4 4 6 4 4 4 4
0 0 0 0 0 0 0 2 2 0 3 0 0 0 0 0 0 0 0 2 3 0 0 0 0 0 0 2 0 2 0 0 0 0 2 2 1 0 0 0 0 2 0 1 0 0 12 12 18 19 19 18 12 12 4 4 4 4 4 6 6 6 4 4 4 5 4 6 6 6 6 6 5 5 5 5 6 12 12 12 4 4 6 6 6 6 6 4 5 5 5 4 4 4 4 4 4 4 4 4
0 2 0 0 0 0 0 0 1 0 1 0 0 0 0 2 0 0 2 0 0 0 0 12 12 12 12 12 12 2 0 0 0 1 0 2 2 2 0 0 0 1 0 0 0 0 12 12 18 20 19 18 12 12 4 6 4 4 6 6 5 6 6 5 5 7 6 5 5 5 5 5 6 5 5 5 6 12 12 4 4 6 5 5 5 5 5 6 4 4 5 4 4 4 4 4 4 4 4 4
0 0 0 0 2 0 0 0 2 0 0 0 0 0 2 2 0 0 0 0 2 2 2 12 12 12 2 2 12 12 12 1 2 3 0 0 0 1 0 0 0 0 0 2 0 12 12 12 12 12 12 12 12 12 5 4 4 5 4 6 6 6 4 4 4 5 6 5 5 5 5 5 6 6 6 6 12 12 4 4 5 6 5 5 5 6 6 6 6 6 4 5 4 4 4 4 4 4 4 6
2 0 0 0 0 2 0 1 0 0 0 0 0 0 0 0 0 0 0 1 0 0 2 12 12 12 12 12 12 12 2 12 0 1 0 0 0 2 0 3 0 1 0 0 0 0 12 12 12 12 12 12 12 12 4 4 4 4 6 4 6 4 4 4 4 6 6 5 5 5 5 5 6 6 12 12 12 12 5 5 6 6 5 5 6 5 5 5 5 5 6 4 4 4 4 4 4 4 4 12
0 2 0 2 0 2 2 0 0 2 0 1 2 0 0 2 1 2 2 1 0 0 3 12 12 12 12 12 12 2 12 12 12 12 0 2 2 0 1 2 2 0 2 0 0 0 12 12 4 4 0 4 4 6 4 4 6 6 6 6 6 4 4 4 12 12 6 5 5 5 5 5 6 12 6 12 12 7 4 4 4 6 5 5 6 5 5 5 5 5 6 4 4 4 4 4 4 4 6 4
2 2 2 0 0 0 1 0 0 0 1 2 0 0 2 0 2 0 0 0 3 2 2 12 12 12 12 12 12 12 3 12 12 12 12 12 3 1 0 0 0 0 0 0 0 0 2 0 2 0 12 12 4 4 4 6 6 6 6 5 5 6 4 12 12 12 6 5 5 5 5 5 6 6 6 6 6 4 7 6 4 6 5 6 6 5 5 5 5 5 6 6 4 6 6 4 4 4 4 12
0 2 0 0 0 0 0 0 1 0 1 2 0 1 2 2 2 0 3 0 0 0 2 12 12 12 12 12 12 12 12 12 12 12 2 12 12 2 0 2 0 0 0 0 0 0 2 0 0 12 12 12 4 7 4 6 6 5 6 6 5 6 12 6 12 12 12 6 6 6 6 6 6 5 6 6 6 4 4 4 4 4 6 6 6 5 5 5 5 5 6 6 6 4 6 4 4 4 4 4
0 0 0 0 2 0 0 2 0 0 0 0 3 2 2 0 0 2 1 2 0 2 12 12 12 12 12 12 12 12 12 12 12 12 12 12 12 12 12 3 0 2 1 0 0 0 0 12 12 12 12 12 4 4 6 6 6 6 6 6 6 6 6 6 6 6 12 12 12 6 6 6 6 6 6 5 6 6 5 4 5 6 4 4 6 5 5 5 6 5 6 5 6 6 4 4 4 4 4 4
2 0 2 0 0 0 1 0 0 0 0 2 1 0 0 0 0 2 0 1 3 12 12 12 12 12 12 12 12 12 12 12 12 12 12 12 12 12 12 12 12 2 0 0 0 0 0 12 12 12 12 4 4 6 4 6 5 6 5 6 6 6 5 5 5 6 12 12 6 5 5 5 5 5 6 6 6 4 4 4 6 6 6 4 5 6 6 6 6 6 6 6 6 4 4 6 4 4 4 12
0 0 0 0 1 0 2 2 2 0 0 0 1 1 2 0 0 0 0 2 2 12 12 12 12 12 12 12 12 12 12 12 12 12 12 12 12 12 12 12 12 12 2 2 0 12 12 12 0 2 12 4 12 12 4 6 5 5 6 6 6 6 5 5 5 6 6 12 6 5 5 5 5 5 6 6 6 4 4 6 6 5 6 6 5 6 5 5 5 5 5 6 4 4 6 12 4 4 4 4
0 12 0 2 0 0 0 0 0 2 2 0 2 0 0 0 0 2 0 3 12 12 2 12 12 2 12 0 0 12 12 12 2 12 12 12 2 12 12 12 12 12 12 12 0 0 12 4 0 12 4 12 10 12 4 6 6 6 6 6 5 6 5 5 5 6 6 6 6 5 5 5 5 5 6 6 7 4 4 4 6 6 6 7 4 6 5 5 5 5 5 6 6 6 6 6 6 4 4 12
12 12 13 2 0 2 0 0 2 0 2 0 0 2 3 0 0 1 0 2 12 12 12 12 12 12 12 0 0 0 2 2 12 12 12 12 12 12 12 12 12 12 12 12 12 12 12 12 12 12 12 4 10 4 6 6 6 5 6 6 6 6 6 6 6 6 5 6 6 5 5 5 5 5 6 4 5 4 5 4 7 6 7 4 6 6 5 5 5 5 5 6 6 5 5 5 5 6 12 12
12 0 0 0 0 0 2 2 0 0 0 0 2 2 0 0 0 0 0 12 12 12 12 12 12 12 0 0 0 0 0 0 12 12 12 12 12 12 12 12 12 12 12 12 12 12 12 12 12 12 12 12 12 6 6 5 6 6 5 6 6 6 12 6 12 6 6 6 6 5 5 5 5 5 6 12 4 12 12 4 5 5 4 4 6 6 5 5 5 5 5 6 5 5 5 5 5 6 12 12
0 0 2 2 0 0 0 0 2 0 0 0 0 2 0 0 0 0 1 12 12 12 12 12 12 12 2 0 2 0 0 0 0 2 12 12 12 12 12 12 12 12 12 12 15 16 16 17 12 12 12 12 12 12 6 6 6 5 5 6 12 12 12 12 12 10 6 9 10 6 6 6 6 6 12 10 12 10 4 12 4 4 4 4 4 6 5 5 5 5 5 6 5 5 5 5 5 6 6 12
12 12 2 12 2 0 0 0 2 0 0 0 0 3 2 0 1 2 12 12 12 12 12 12 12 2 2 3 2 0 0 1 0 0 0 2 12 12 12 12 12 12 12 12 18 19 19 18 12 12 12 12 12 12 12 6 6 6 6 6 12 12 12 10 10 10 10 10 10 10 10 6 12 12 12 9 10 12 12 6 4 4 4 4 6 6 6 6 6 6 6 6 5 5 5 5 5 6 12 12
12 2 12 12 2 0 2 0 0 0 0 0 0 0 2 2 0 1 12 12 12 12 12 12 12 0 1 2 0 0 0 0 0 0 0 2 0 12 12 12 12 12 12 12 18 20 19 18 12 12 12 12 12 12 12 12 12 6 12 12 12 12 9 10 10 10 10 10 10 9 10 10 12 12 12 10 10 12 12 12 12 4 4 6 4 4 6 6 6 6 6 6 5 5 5 5 5 6 12 12
12 12 12 0 2 12 0 0 0 0 2 0 2 0 2 0 0 14 12 12 12 12 12 12 0 2 2 2 0 0 0 0 0 2 0 0 2 2 0 12 12 12 12 12 12 12 12 12 12 12 12 12 12 12 12 12 12 12 12 12 12 9 10 11 10 10 10 10 10 10 10 10 10 10 10 12 12 12 12 12 12 9 7 4 6 4 4 4 6 4 4 12 6 6 6 6 6 12 12 12
12 12 0 0 2 12 0 2 0 0 0 0 0 1 2 0 0 12 12 12 12 12 12 12 0 0 2 2 0 0 0 0 0 0 3 0 0 0 0 3 12 12 12 12 12 12 12 12 12 12 12 12 12 12 12 12 12 12 12 12 10 10 10 10 10 10 9 10 10 10 9 9 10 9 10 10 10 12 4 10 10 10 4 4 4 4 4 4 4 4 4 6 12 12 6 12 12 12 12 12
12 12 12 0 12 12 0 0 0 0 1 0 2 1 0 2 2 12 2 12 12 12 12 0 3 0 0 0 0 0 3 0 0 2 2 3 2 0 2 0 12 12 12 12 12 12 12 12 12 12 12 12 12 12 12 12 12 12 12 12 10 10 10 10 9 10 10 10 10 10 10 10 10 10 10 10 10 10 12 12 9 12 4 12 4 4 4 4 4 4 4 12 12 12 12 12 12 12 12 12
12 12 12 12 12 2 0 0 2 0 0 0 2 1 0 2 12 12 12 12 12 12 12 1 0 0 0 0 0 0 2 2 0 0 0 2 0 0 2 2 12 12 12 12 12 12 12 12 12 12 12 12 12 12 12 15 16 17 12 12 10 9 11 10 10 9 9 10 10 10 9 10 10 10 10 10 10 10 10 12 4 9 12 12 4 12 12 12 4 4 4 4 12 12 12 12 12 12 12 12
12 12 12 0 12 12 12 0 0 0 0 2 2 2 0 0 12 12 2 12 12 12 0 0 0 0 1 0 1 3 0 1 1 0 0 0 0 0 2 3 12 0 0 12 12 12 12 12 12 12 12 12 12 12 12 18 19 18 12 12 9 8 10 10 10 11 10 10 10 10 10 10 10 10 9 10 10 9 10 10 12 12 10 10 12 12 12 4 12 12 4 4 12 6 12 12 12 12 12 12
12 12 12 12 12 12 0 0 12 2 0 2 0 0 2 3 12 12 12 12 12 12 3 0 2 2 2 2 0 0 1 0 3 0 3 0 0 2 2 2 0 12 0 12 12 12 12 12 12 12 12 12 12 12 12 18 20 18 12 12 10 9 11 8 10 9 11 9 12 12 12 12 12 12 12 12 10 10 10 10 10 12 4 12 12 12 12 4 12 4 12 4 12 12 12 12 12 12 12 12
12 12 12 12 2 0 12 12 0 2 2 0 2 0 0 0 12 12 12 12 12 3 0 0 0 2 0 0 0 2 0 2 12 12 12 2 12 12 10 3 12 0 12 0 12 12 12 12 12 12 12 12 12 12 12 12 12 12 12 12 10 8 10 10 10 10 10 10 12 12 12 12 12 12 12 12 10 9 10 10 10 10 12 12 12 12 12 12 4 12 12 4 12 12 12 12 12 12 12 12
2 12 12 12 12 0 0 12 12 2 12 0 0 0 2 2 12 12 14 12 12 2 2 2 0 1 0 0 0 0 2 12 10 1 0 12 10 2 12 0 12 12 12 12 12 12 12 12 12 12 12 12 12 12 12 12 12 12 12 12 8 8 8 11 8 10 11 9 12 12 15 16 16 17 12 12 10 11 10 10 10 10 10 12 12 10 12 12 12 12 12 12 12 12 12 12 12 12 12 12
12 12 12 12 12 12 12 12 12 12 0 0 12 0 2 0 2 2 0 0 0 3 0 2 0 0 0 0 0 0 1 12 12 2 12 9 12 12 12 9 12 10 10 10 12 12 12 12 12 12 12 12 12 12 12 12 8 12 11 10 11 8 8 9 8 8 11 8 12 12 18 19 19 18 12 12 10 10 10 10 9 9 9 10 12 4 10 12 9 12 12 12 12 12 12 12 12 12 12 12
12 12 12 12 12 12 12 12 12 12 12 0 2 12 12 0 0 0 0 12 2 0 0 0 2 0 0 0 0 2 0 12 2 12 2 12 12 10 2 3 12 11 10 10 12 12 12 12 8 8 12 12 12 12 8 12 12 12 8 8 11 10 10 9 10 10 11 8 12 12 18 20 19 18 12 12 9 9 9 10 11 9 11 10 10 12 12 12 12 12 12 12 12 12 12 12 12 12 12 12
12 12 12 12 12 12 12 12 12 0 12 12 12 12 0 0 0 12 0 2 0 3 0 0 0 0 2 0 0 2 2 12 10 9 0 12 12 10 10 9 12 10 10 10 10 10 9 8 8 12 12 8 12 12 9 12 12 12 12 10 10 9 10 10 10 10 10 11 12 12 12 12 12 12 12 12 9 9 9 9 11 11 9 10 10 9 12 10 12 12 12 12 12 12 12 12 12 12 12 12
12 12 12 12 12 12 12 12 12 12 12 12 12 12 12 12 2 12 14 12 14 12 0 2 0 12 0 12 2 0 0 10 12 12 12 10 10 10 9 11 10 10 10 10 10 9 12 12 12 8 8 12 12 12 12 8 12 12 12 8 8 10 10 10 8 10 8 10 12 12 12 12 12 12 12 12 11 9 9 9 9 9 10 10 10 10 10 10 12 12 12 10 12 12 12 12 12 12 12 12
12 12 12 12 12 12 12 12 12 12 12 12 12 12 0 0 12 3 12 0 0 2 3 0 0 2 0 0 0 12 2 2 10 10 10 10 10 10 10 10 10 10 10 10 10 10 12 12 12 8 12 12 12 12 12 12 12 12 12 10 10 9 10 10 10 9 10 10 8 10 10 10 8 10 10 9 9 9 9 9 9 9 10 10 9 9 9 8 8 10 12 12 12 12 8 12 12 12 12 12
12 12 12 12 12 12 12 12 12 12 12 12 12 12 12 12 12 12 12 12 12 0 12 12 2 12 12 12 12 12 12 12 12 12 10 10 9 10 10 10 9 9 9 10 10 10 12 12 12 12 12 11 12 12 12 12 12 12 12 12 10 10 10 10 8 9 9 9 8 8 10 8 10 9 9 9 9 9 10 10 10 10 9 10 9 9 9 9 9 12 9 12 12 8 8 12 12 12 12 12
12 12 12 12 12 12 12 12 12 12 12 12 8 12 12 12 12 12 12 0 2 12 12 0 12 12 0 0 0 12 12 12 12 9 10 10 10 10 10 10 9 9 9 10 10 12 12 8 12 12 12 12 12 8 12 9 12 8 12 12 9 10 9 9 9 11 9 9 9 11 9 9 9 9 9 9 11 9 10 10 9 10 9 10 9 9 9 9 9 9 9 12 10 12 12 12 12 12 12 12
12 12 12 8 12 12 8 12 12 12 12 12 12 12 12 8 12 12 12 12 12 12 0 12 12 12 12 12 2 12 12 12 12 9 10 10 10 10 9 10 9 9 9 10 10 12 12 12 12 12 12 12 12 12 12 8 12 12 8 12 12 12 12 12 12 12 12 11 10 10 9 9 9 9 9 9 9 10 10 9 11 10 10 9 10 11 10 10 9 9 8 8 12 12 12 12 12 12 12 12
12 12 12 12 12 12 12 12 8 12 12 12 12 12 12 12 12 12 12 12 12 12 12 12 12 12 12 12 8 12 12 12 10 10 10 10 10 10 10 10 10 10 11 10 9 12 12 12 12 12 12 8 12 12 8 8 9 12 12 12 12 12 12 12 12 12 12 8 9 8 9 9 9 10 9 9 9 10 11 10 10 11 10 10 10 9 9 9 10 12 12 12 12 12 12 12 12 12 12 12
12 12 12 12 12 12 12 12 12 12 12 8 12 12 12 12 12 12 12 12 12 12 12 12 12 12 12 12 12 8 9 10 10 10 10 10 10 10 10 10 10 10 9 9 12 12 12 12 12 12 12 9 12 12 12 12 12 12 12 12 12 12 15 16 17 12 12 8 9 9 9 10 10 8 9 9 9 9 8 9 11 10 10 9 10 9 9 9 10 9 12 12 12 12 12 12 12 12 8 12
12 12 12 12 12 12 12 12 12 12 12 12 12 12 12 12 12 12 12 12 12 12 12 12 12 12 12 12 10 10 10 10 10 10 10 10 10 10 10 10 10 10 9 9 12 12 12 12 12 12 9 10 12 12 12 9 12 12 12 12 12 12 18 19 18 12 12 8 9 9 9 8 10 8 11 10 11 10 10 10 10 11 10 10 10 9 9 9 10 10 10 10 12 12 12 12 12 12 12 12
12 12 12 12 12 12 12 12 12 12 12 12 12 12 12 12 12 12 12 12 12 12 12 12 12 12 12 12 12 12 10 12 9 10 10 10 12 12 12 12 12 12 12 12 8 12 12 12 12 12 10 10 10 12 8 9 12 12 12 12 12 12 18 20 18 12 12 10 9 9 9 10 9 9 10 10 10 10 9 9 9 10 10 10 10 9 9 9 10 10 12 12 10 8 12 12 12 12 12 12
12 12 12 12 12 12 12 12 12 12 12 12 12 12 12 12 12 12 12 12 12 12 12 12 12 12 8 12 12 12 12 10 10 9 10 10 12 12 12 12 12 12 12 12 12 12 12 8 12 12 11 10 8 12 9 9 12 12 12 12 12 12 12 12 12 12 12 8 8 10 10 11 10 9 11 8 10 10 9 9 9 9 10 10 10 10 10 10 10 10 10 12 12 10 12 12 12 12 12 12
12 12 12 12 12 12 12 12 12 8 8 12 12 12 12 12 12 12 12 12 12 12 12 12 12 12 8 12 12 12 9 10 9 10 10 10 12 12 15 16 17 12 12 9 12 12 12 12 12 10 9 11 10 8 12 12 8 12 12 12 12 12 12 12 12 12 12 8 11 10 10 10 8 8 10 10 9 10 9 9 9 9 10 11 10 10 10 10 10 10 12 10 12 12 12 12 12 12 12 12
8 12 12 8 12 12 12 12 12 8 12 12 12 12 12 12 12 12 12 12 12 12 12 12 12 12 8 12 12 12 12 10 10 10 10 10 12 12 18 19 18 12 12 12 12 12 12 12 12 10 8 10 9 10 12 12 12 8 12 12 12 9 12 12 10 9 10 8 10 10 10 10 10 10 10 9 11 9 10 9 10 10 11 11 10 10 10 10 9 10 10 12 8 12 12 12 12 12 12 12
12 12 12 12 12 12 12 12 8 12 12 12 12 12 12 12 8 12 12 12 12 12 12 12 12 12 12 12 12 12 10 10 10 10 10 10 12 12 18 20 18 12 12 8 12 12 12 12 10 8 11 10 8 10 10 12 12 12 12 12 12 12 12 12 10 8 8 8 10 9 9 8 11 10 10 9 11 11 10 10 10 10 10 10 10 10 10 11 10 11 10 12 10 8 12 12 12 12 12 12
12 12 12 12 12 12 12 12 12 12 12 12 12 12 12 12 12 12 12 12 12 12 12 12 12 12 12 12 10 12 10 10 10 10 10 10 12 12 12 12 12 12 12 12 12 12 12 12 10 8 8 11 10 8 8 12 12 12 12 12 8 8 12 12 12 10 9 11 9 11 9 10 8 10 8 10 9 11 11 9 9 9 11 11 10 9 10 11 11 12 10 12 10 12 12 12 12 12 12 8
12 12 12 12 12 12 12 12 12 12 12 12 12 12 12 12 12 12 12 12 12 12 12 12 12 12 12 10 10 10 10 10 10 9 10 9 12 12 12 12 12 12 12 12 12 12 12 12 11 10 10 10 9 9 9 8 12 12 12 12 12 12 8 12 12 9 9 10 9 11 9 11 11 10 8 11 9 9 9 9 9 9 10 10 10 10 10 9 9 9 10 9 12 12 12 12 12 12 12 12
12 12 12 12 12 12 8 12 12 12 12 12 12 12 12 12 12 12 12 12 12 12 12 12 12 12 12 12 10 8 12 10 10 10 10 10 10 10 10 10 8 12 12 12 12 12 12 11 8 9 8 9 9 9 11 10 12 12 12 12 12 8 12 12 12 8 9 9 9 11 9 9 11 8 10 10 9 9 9 9 9 9 10 9 10 10 9 9 11 9 12 9 12 12 12 12 12 12 12 12
8 12 12 12 12 8 8 12 12 12 12 12 12 12 8 12 12 12 12 12 8 12 12 12 12 12 12 12 9 12 10 10 9 9 10 10 10 10 10 10 8 12 12 12 12 12 12 11 10 10 10 10 9 9 9 8 10 12 12 12 12 12 12 12 12 12 12 9 9 9 9 11 9 11 10 8 9 9 9 8 11 10 10 10 10 10 11 9 9 9 10 10 12 12 12 12 12 12 12 12
12 12 8 12 12 12 12 12 12 12 12 12 12 12 12 12 8 12 12 12 12 12 12 12 12 12 12 12 12 10 12 12 10 10 10 10 10 10 10 10 12 12 12 12 12 12 10 8 10 10 11 10 11 11 10 8 10 12 12 12 12 12 12 12 12 12 8 9 9 9 9 11 9 10 11 10 8 10 10 9 9 9 10 10 11 10 9 9 9 9 10 10 10 12 8 12 12 12 12 12
12 12 12 12 12 12 12 12 8 12 12 12 12 12 12 12 12 12 12 12 12 12 12 8 12 8 12 12 12 12 9 10 10 10 10 10 10 10 10 10 12 12 12 12 12 12 10 10 8 10 9 10 8 10 10 9 8 10 10 12 8 12 8 12 12 12 12 12 9 9 9 9 9 8 8 10 8 9 10 9 9 9 10 10 10 10 9 9 9 10 10 9 12 12 12 12 12 12 8 12
12 12 12 12 12 12 12 12 12 12 12 12 12 12 8 12 12 12 12 12 12 12 12 12 12 12 12 12 12 9 12 10 10 10 10 10 10 10 9 12 12 12 12 12 8 12 8 9 8 8 8 8 11 8 10 8 10 9 8 8 12 12 12 12 12 12 12 12 12 9 9 9 11 8 10 10 8 10 9 9 9 9 9 10 10 11 11 9 9 11 10 10 10 12 12 12 12 12 12 12
12 12 12 12 12 12 12 12 12 8 12 12 12 12 12 12 12 12 12 12 12 12 12 12 12 12 12 12 10 12 12 10 10 10 10 10 10 10 9 8 12 12 12 12 12 10 10 8 10 10 8 10 10 9 10 8 9 10 10 11 12 8 12 12 8 12 12 12 12 12 11 11 9 10 10 8 11 11 11 9 9 10 10 10 11 10 10 10 9 10 10 10 10 12 12 12 12 12 12 12
12 12 12 12 12 12 12 12 12 12 12 12 12 12 12 12 12 12 12 12 12 12 12 8 12 12 12 12 12 12 10 10 10 10 10 10 10 10 12 12 12 12 12 12 12 11 8 10 10 10 9 9 9 9 9 9 9 9 8 10 8 12 12 12 12 8 8 8 8 12 12 9 10 8 8 8 10 10 9 11 9 10 10 11 9 10 10 10 12 12 10 12 12 12 12 12 12 12 12 12
8 12 12 12 12 12 12 12 12 12 12 12 12 12 12 12 12 12 8 12 12 12 12 12 8 12 12 12 12 8 12 10 9 10 9 10 10 10 12 12 12 9 12 12 12 9 9 8 8 10 8 9 9 9 9 9 9 9 10 8 10 12 12 12 12 12 12 12 12 12 12 8 8 8 8 9 10 11 10 10 10 10 10 10 10 10 10 9 10 10 8 10 12 12 12 12 12 12 12 12
12 12 12 12 12 12 12 12 12 12 12 12 12 12 12 8 12 12 12 12 12 12 12 12 12 12 12 12 12 12 10 10 10 10 10 10 10 10 8 12 12 12 12 12 9 9 9 8 10 8 10 9 9 9 9 9 9 11 9 8 10 11 12 12 8 12 8 8 12 12 12 8 8 10 11 10 9 10 10 9 10 9 10 9 10 10 9 10 10 10 8 12 12 12 12 12 12 12 12 12
12 12 12 12 12 12 12 12 12 12 12 12 12 12 12 12 12 12 12 12 12 12 12 12 12 12 12 12 12 10 8 9 12 10 10 9 10 10 12 12 12 12 12 12 9 11 11 11 10 8 8 11 8 10 8 8 8 10 8 8 9 9 8 8 12 12 12 8 12 12 12 12 12 10 8 8 9 10 10 10 9 11 9 10 10 10 10 10 12 10 12 12 12 12 12 12 12 12 12 12
8 12 12 12 8 12 12 12 12 12 12 12 12 12 12 12 12 12 12 12 8 12 8 12 12 12 12 12 12 12 12 9 10 10 10 9 10 9 12 12 12 12 12 9 10 8 10 11 10 10 10 11 10 9 8 11 9 9 11 10 10 10 10 10 12 12 8 12 12 8 12 12 12 10 10 10 9 8 10 10 10 10 10 10 10 10 10 10 12 12 12 12 12 12 12 12 12 12 8 12
8 12 12 12 12 12 12 12 12 12 12 12 8 12 12 12 12 12 12 12 12 12 12 12 12 12 12 12 12 12 9 12 10 10 12 10 10 10 12 12 8 12 12 10 8 10 10 10 8 10 10 8 8 11 8 8 9 9 9 8 10 10 10 10 8 12 12 12 12 8 12 12 12 12 9 9 10 9 10 10 10 9 10 9 10 10 12 12 9 12 12 12 12 12 12 12 12 12 12 12
12 12 12 12 12 12 12 8 12 12 12 12 12 12 12 12 8 12 12 12 12 12 12 12 12 12 12 12 12 10 12 12 12 10 8 10 9 10 10 10 10 9 10 10 9 10 10 10 8 10 10 9 8 9 10 8 9 9 9 8 10 10 10 9 9 12 12 12 12 12 8 8 12 12 12 11 9 10 10 9 11 11 10 10 10 11 10 11 10 12 12 12 12 12 12 12 12 12 12 12
12 12 12 12 12 12 12 12 12 12 12 12 8 12 12 12 12 12 12 12 12 12 12 12 12 12 12 12 8 12 10 12 12 10 12 9 10 10 9 10 10 10 10 10 11 9 9 9 10 9 9 10 8 10 9 9 10 10 8 8 10 10 10 11 9 9 8 12 12 12 12 12 12 12 12 9 9 10 9 9 9 9 10 10 10 9 10 9 12 10 12 12 12 8 12 12 12 12 12 12
12 12 12 12 12 12 12 12 12 12 12 12 12 12 12 12 12 12 12 12 12 12 12 12 12 12 12 12 12 12 12 12 12 12 10 10 10 10 9 9 10 9 10 10 10 9 9 9 10 10 11 8 10 8 8 8 10 10 10 10 9 9 9 9 9 9 8 12 12 12 12 12 12 12 12 9 11 9 10 9 9 11 10 10 10 10 10 10 12 12 12 12 12 12 12 8 12 12 12 12
12 12 12 12 12 12 12 12 8 12 12 12 12 12 12 12 12 12 12 12 12 12 12 8 12 12 12 12 12 12 12 12 9 12 9 10 12 9 10 10 10 9 10 10 10 9 9 9 10 10 11 10 10 10 10 11 10 11 11 9 9 9 9 11 8 10 8 12 12 12 12 12 12 12 11 11 9 10 10 10 10 10 10 9 9 10 10 12 8 12 12 8 12 12 12 12 12 12 12 12
12 12 12 12 12 12 8 12 12 12 12 12 12 12 12 12 8 12 12 12 12 12 12 12 12 12 12 12 12 12 12 12 12 8 12 12 10 10 10 10 10 10 10 10 9 10 10 10 10 9 10 10 10 10 10 11 10 10 9 9 9 9 9 9 9 10 10 11 12 12 12 12 12 12 12 11 10 10 10 11 9 9 12 9 10 12 10 12 12 10 12 12 12 12 12 12 8 12 12 12
12 12 12 12 12 12 12 12 12 12 12 12 12 12 12 12 12 12 8 12 12 12 12 12 12 12 12 12 12 12 12 12 12 12 12 12 10 9 10 9 10 10 9 10 10 10 10 10 10 10 11 8 10 10 10 10 11 8 11 9 9 11 9 9 9 9 9 9 8 12 12 12 12 12 12 10 10 10 10 10 10 10 10 8 10 10 9 8 8 12 12 12 12 12 12 12 8 12 12 12
12 12 12 12 12 12 12 12 12 12 12 8 12 12 12 12 12 12 12 12 12 8 12 12 12 12 12 12 12 12 12 12 12 12 10 12 10 10 10 10 10 10 10 10 10 11 10 10 9 10 9 8 9 10 11 8 10 10 10 9 8 10 9 9 9 9 9 9 9 10 10 10 10 10 10 10 9 10 10 9 10 10 10 12 10 12 9 12 12 12 12 12 12 12 12 12 12 12 12 12
12 12 12 12 12 12 12 12 12 12 12 12 12 12 12 12 12 12 12 12 12 12 12 12 12 12 12 12 12 12 12 12 12 12 12 12 12 12 10 10 10 9 10 9 10 10 10 11 10 11 9 10 8 9 9 9 10 9 10 10 9 10 10 9 9 11 9 9 9 9 9 10 9 10 10 10 10 10 10 9 10 10 12 10 12 12 8 9 12 8 12 12 12 12 8 12 12 12 12 12
12 12 12 12 12 12 12 12 12 12 12 12 12 12 12 12 12 12 12 12 12 12 12 12 12 12 12 12 12 12 12 12 12 12 12 10 10 12 10 12 12 10 10 10 10 10 10 9 10 10 9 11 10 9 9 9 10 10 10 10 10 10 10 9 9 9 10 10 9 9 9 11 10 10 10 10 10 10 10 10 10 10 10 12 12 12 12 12 12 12 12 12 12 12 12 12 12 12 12 12
12 12 12 12 12 12 12 12 12 12 12 12 12 12 12 8 8 12 12 12 12 12 12 12 12 12 12 12 12 12 12 12 12 12 10 12 8 12 12 12 12 10 10 10 10 10 10 10 10 10 10 11 10 9 9 9 10 10 9 10 10 10 10 10 10 10 10 10 9 9 9 10 10 10 10 10 10 10 10 12 10 10 13 10 9 12 12 12 12 12 12 12 12 12 12 12 12 12 12 12
12 12 12 12 12 12 12 12 12 12 12 8 12 12 12 12 12 12 12 12 8 8 12 12 12 12 12 12 12 12 12 12 12 12 12 12 12 10 10 12 10 12 10 12 10 10 10 10 10 9 9 10 10 10 9 10 10 10 9 10 10 9 10 10 9 10 10 10 10 10 10 10 10 10 10 10 10 10 9 10 10 12 10 12 12 12 12 12 12 12 12 12 12 12 12 12 12 12 12 12
12 12 12 12 12 12 12 12 12 12 12 12 12 12 12 12 12 12 12 12 12 12 12 12 12 12 12 12 12 12 12 12 12 12 12 12 12 10 10 12 10 12 10 10 10 10 10 10 10 10 10 10 9 9 10 10 10 10 9 11 10 10 9 10 10 10 10 9 9 10 10 10 10 9 10 10 9 10 10 9 12 12 12 12 12 12 12 12 8 12 8 12 12 12 12 12 12 12 12 12
12 12 8 12 12 12 12 12 12 8 12 12 12 8 12 12 12 12 12 12 12 12 12 12 12 12 12 8 12 8 12 12 12 12 12 12 12 12 12 8 10 12 12 10 10 12 10 10 10 10 9 10 10 10 10 10 10 10 10 10 10 10 10 10 10 10 10 10 10 10 10 10 9 10 10 12 12 10 8 12 10 12 12 12 12 12 12 12 12 12 12 12 12 12 12 12 12 12 12 12
12 12 12 12 12 12 12 12 12 12 12 12 12 12 12 12 12 12 12 12 12 12 12 12 12 12 12 12 12 12 12 12 12 12 12 12 12 12 12 12 10 12 12 12 12 10 12 10 9 10 9 10 10 10 10 10 10 10 10 10 9 10 10 9 10 10 10 10 10 10 10 10 10 10 9 10 10 10 10 12 12 12 12 12 12 12 12 12 12 12 8 12 12 12 12 12 12 12 12 12
12 12 12 12 8 12 12 12 12 12 12 12 12 12 12 12 8 12 12 12 12 12 12 12 12 12 12 12 12 12 12 12 12 12 12 12 12 12 12 12 12 12 8 9 9 8 10 10 10 9 12 10 12 10 10 10 10 10 10 10 10 10 10 10 9 10 9 10 10 10 10 10 12 10 10 10 8 12 10 12 12 12 12 12 12 12 12 12 8 12 12 12 12 12 12 12 12 12 12 12
