100 100
5 4 4 4 4 4 4 4 4 5 4 4 4 4 4 4 4 4 5 4 4 4 4 6 4 4 4 5 4 7 4 4 4 4 4 4 5 4 4 4 4 4 4 4 4 5 6 4 4 4 4 4 4 4 5 4 4 4 7 4 4 4 4 5 4 4 4 4 4 6 4 4 5 4 4 4 4 4 4 4 4 5 4 4 4 4 4 7 4 4 5 4 6 4 4 4 4 4 4 5
4 4 4 4 4 4 4 4 5 4 4 4 4 6 4 4 4 5 4 4 4 4 4 4 4 4 5 4 4 4 4 4 4 4 4 5 6 7 4 4 4 4 4 4 5 4 4 4 4 4 4 4 4 5 4 4 4 4 4 6 4 4 5 4 4 4 7 4 4 4 4 5 4 4 4 4 4 4 4 4 5 4 6 4 4 4 4 4 4 5 4 4 4 4 4 7 4 4 5 4
4 4 4 6 4 4 4 5 4 4 4 4 4 4 4 4 5 4 4 4 4 4 4 4 4 5 6 4 4 4 4 4 4 4 5 4 4 4 4 4 4 4 4 5 4 7 4 4 4 6 4 4 5 4 4 4 4 4 4 4 4 5 4 4 4 4 4 4 4 4 5 4 6 4 7 4 4 4 4 5 4 4 4 4 4 4 4 4 5 4 4 4 4 4 4 6 4 5 4 4
4 4 4 4 4 4 5 4 4 4 4 4 4 4 4 5 6 4 4 4 4 4 4 4 5 4 4 4 4 4 4 4 4 5 4 4 4 4 4 6 4 4 5 4 4 4 4 4 4 4 4 5 4 7 4 4 4 4 4 4 5 4 6 4 4 4 4 4 4 5 4 4 4 4 4 4 4 4 5 4 4 4 7 4 4 6 4 5 4 4 4 4 4 4 4 4 5 4 4 4
4 4 4 7 4 5 6 4 4 4 4 4 4 4 5 4 4 4 4 4 4 4 4 5 4 4 4 4 4 6 4 4 5 4 4 4 4 4 4 4 4 5 4 4 4 4 4 4 4 4 5 4 6 4 4 4 4 4 4 5 4 7 4 4 4 4 4 4 5 4 4 4 4 4 4 6 4 5 4 4 4 4 4 4 4 4 5 4 4 4 7 4 4 4 4 5 4 4 6 4
4 4 4 4 5 4 4 4 4 4 4 7 4 5 4 4 4 4 4 6 4 4 5 4 4 4 4 4 4 4 4 5 4 4 4 4 4 4 4 4 5 4 6 4 4 4 4 4 4 5 4 4 4 4 4 4 4 4 5 4 4 4 4 4 4 6 4 5 4 7 4 4 4 4 4 4 5 4 4 4 4 4 4 4 4 5 4 4 6 4 4 4 4 4 5 4 4 4 7 4
4 4 4 5 4 4 4 4 4 6 4 4 5 4 4 4 4 4 4 7 4 5 4 4 4 4 4 4 4 4 5 4 6 4 4 4 4 4 4 5 4 4 4 4 4 4 4 4 5 4 4 4 4 4 4 6 4 5 4 4 4 4 4 4 4 4 5 4 4 4 4 4 4 4 4 5 4 7 6 4 4 4 4 4 5 4 4 4 4 4 4 4 4 5 4 4 4 4 4 4
4 4 5 4 4 4 4 4 4 4 4 5 4 4 4 4 4 4 4 4 5 4 6 4 4 4 4 7 4 5 4 4 4 4 4 4 4 4 5 4 4 4 4 4 4 6 4 5 4 4 4 4 4 4 4 4 5 4 4 4 4 4 4 4 4 5 4 4 6 4 4 4 4 4 5 4 4 4 4 4 4 4 4 5 4 7 4 4 4 4 4 6 5 4 4 4 4 4 4 4
4 5 4 4 4 4 7 4 4 4 5 4 6 4 4 4 4 4 4 5 4 4 4 4 4 4 4 4 5 4 4 4 4 4 4 6 4 5 4 4 4 4 4 4 4 4 5 4 4 4 4 4 4 4 4 5 4 4 6 4 4 4 4 4 5 4 4 4 4 4 4 4 4 5 4 4 4 4 4 4 4 6 5 4 4 4 4 4 4 4 4 5 4 7 4 4 4 4 4 4
5 4 6 4 4 4 4 4 4 5 4 4 4 4 7 4 4 4 5 4 4 4 4 4 4 6 4 5 4 4 4 4 4 4 4 4 5 4 4 4 4 4 4 7 4 5 4 4 6 4 4 4 4 4 5 4 4 4 4 4 4 4 4 5 4 4 4 4 4 4 4 6 5 4 4 4 4 4 4 4 4 5 4 4 4 4 4 4 4 4 5 4 4 4 6 4 4 4 4 5
4 4 4 4 4 4 4 4 5 4 4 4 4 4 4 6 4 5 4 4 4 4 7 4 4 4 5 4 4 4 4 4 4 4 4 5 4 4 6 4 4 4 4 4 5 4 4 4 4 4 4 7 4 5 4 4 4 4 4 4 4 6 5 4 4 4 4 4 4 4 4 5 4 4 4 4 4 4 4 4 5 4 4 4 6 4 4 4 4 5 4 4 4 4 4 4 4 4 5 4
4 7 4 4 4 6 4 5 4 4 4 4 4 4 4 4 5 4 4 4 4 4 4 4 4 5 4 4 6 4 7 4 4 4 5 4 4 4 4 4 4 4 4 5 4 4 4 4 4 4 4 6 5 4 4 4 4 4 4 7 4 5 4 4 4 4 4 4 4 4 5 4 4 4 6 4 4 4 4 5 4 4 4 4 4 4 4 4 5 4 4 4 4 4 4 4 4 5 4 4
4 4 4 4 4 4 5 4 4 7 4 4 4 4 4 5 4 4 6 4 4 4 4 4 5 4 4 4 4 4 4 4 4 5 4 4 4 4 7 4 4 6 5 4 4 4 4 4 4 4 4 5 4 4 4 4 4 4 4 4 5 4 4 4 6 4 4 7 4 5 4 4 4 4 4 4 4 4 5 4 4 4 4 4 4 4 4 5 4 4 4 4 4 4 4 4 5 4 4 4
4 4 4 4 4 5 4 4 6 4 4 4 4 4 5 4 4 7 4 4 4 4 4 5 4 4 4 4 4 4 4 6 5 4 4 4 4 4 4 4 4 5 4 4 4 4 7 4 4 4 5 4 4 4 6 4 4 4 4 5 4 4 4 4 4 4 4 4 5 4 4 4 4 4 4 7 4 5 4 4 4 4 4 4 4 4 5 4 4 4 4 4 4 4 4 5 4 4 4 4
4 4 4 4 5 4 4 4 4 4 4 4 4 5 4 4 4 4 4 4 4 6 5 4 4 7 4 4 4 4 4 5 4 4 4 4 4 4 4 4 5 4 4 4 6 4 4 4 4 5 4 4 4 4 7 4 4 4 5 4 4 4 4 4 4 4 4 5 4 4 4 4 4 4 4 4 5 4 4 4 4 4 4 7 4 5 4 4 4 4 6 4 4 4 5 4 4 4 4 4
4 4 4 5 7 4 4 4 4 4 4 6 5 4 4 4 4 4 4 4 4 5 4 4 4 4 4 4 4 4 5 4 4 7 6 4 4 4 4 5 4 4 4 4 4 4 4 4 5 4 4 4 4 4 4 4 4 5 4 4 4 4 7 4 4 4 5 4 4 4 4 4 4 4 4 5 4 4 4 4 6 4 4 4 5 4 4 4 4 4 4 7 4 5 4 4 4 4 4 4
4 6 5 4 4 4 4 4 4 4 4 5 7 4 4 4 4 4 4 4 5 4 4 4 6 4 4 4 4 5 4 4 4 4 4 4 4 4 5 4 4 7 4 4 4 4 4 5 4 4 4 4 4 4 4 4 5 4 4 4 4 4 4 4 4 5 4 4 4 4 6 4 4 4 5 4 4 4 4 4 4 4 4 5 4 4 4 4 4 4 4 4 5 6 4 4 4 4 4 7
4 5 4 4 4 4 4 4 4 4 5 4 4 4 6 4 4 4 4 5 7 4 4 4 4 4 4 4 5 4 4 4 4 4 4 4 4 5 4 4 4 4 4 4 4 4 5 4 4 7 4 4 4 4 4 5 4 4 4 4 6 4 4 4 5 4 4 4 4 4 4 4 4 5 4 4 4 4 7 4 4 4 5 6 4 4 4 4 4 4 4 5 4 4 4 4 4 4 4 4
5 4 4 4 6 4 4 4 4 5 4 4 4 4 4 4 4 4 5 4 4 4 4 4 4 4 4 5 7 4 4 4 4 4 4 4 5 4 4 4 4 4 4 4 4 5 4 4 4 4 6 4 4 4 5 4 4 7 4 4 4 4 4 5 4 4 4 4 4 4 4 4 5 6 4 4 4 4 4 4 4 5 4 4 4 4 7 4 4 4 5 4 4 4 4 4 6 4 4 5
4 4 4 4 4 4 4 7 5 4 4 4 4 4 4 4 4 5 4 4 4 4 4 4 4 4 5 4 4 4 4 4 4 4 4 5 7 4 4 4 6 4 4 4 5 4 4 4 4 4 4 4 4 5 4 4 4 4 4 4 4 4 5 6 4 7 4 4 4 4 4 5 4 4 4 4 4 4 4 4 5 4 4 4 4 4 6 4 4 5 4 4 4 4 7 4 4 4 5 4
4 4 4 4 4 4 4 5 4 4 4 4 4 4 4 7 5 4 4 4 4 4 4 4 4 5 4 4 4 4 6 4 4 4 5 4 4 4 4 4 4 4 4 5 7 4 4 4 4 4 4 4 5 6 4 4 4 4 4 4 4 5 4 4 4 4 4 4 4 4 5 4 4 7 4 4 6 4 4 5 4 4 4 4 4 4 4 4 5 4 4 4 4 4 4 4 4 5 4 6
4 4 4 4 4 4 5 4 4 4 4 4 4 4 4 5 4 4 4 4 6 4 4 7 5 4 4 4 4 4 4 4 4 5 4 4 4 4 4 4 4 4 5 6 4 4 4 4 4 4 4 5 7 4 4 4 4 4 4 4 5 4 4 4 4 4 6 4 4 5 4 4 4 4 4 4 4 4 5 4 4 7 4 4 4 4 4 5 4 6 4 4 4 4 4 4 5 4 4 4
4 4 7 4 4 5 4 4 4 4 6 4 4 4 5 4 4 4 4 4 4 4 4 5 4 4 4 4 4 4 4 7 5 6 4 4 4 4 4 4 4 5 4 4 4 4 4 4 4 4 5 4 4 4 4 4 6 4 4 5 7 4 4 4 4 4 4 4 5 4 4 4 4 4 4 4 4 5 4 6 4 4 4 4 4 4 5 4 4 7 4 4 4 4 4 5 4 4 4 4
6 4 4 4 5 4 4 4 4 4 7 4 4 5 4 4 4 4 4 4 4 4 5 6 4 4 4 4 4 4 4 5 4 4 4 4 4 4 4 7 5 4 4 4 4 4 6 4 4 5 4 4 4 4 4 4 4 4 5 4 4 4 4 4 4 4 4 5 7 6 4 4 4 4 4 4 5 4 4 4 4 4 4 4 4 5 4 4 4 4 4 4 6 4 5 4 4 7 4 4
4 4 4 5 4 4 4 4 4 4 4 4 5 6 4 4 4 4 7 4 4 5 4 4 4 4 4 4 4 4 5 4 4 4 4 4 6 4 4 5 4 4 4 4 4 4 4 7 5 4 4 4 4 4 4 4 4 5 4 6 4 4 4 4 4 4 5 4 4 4 4 4 4 4 4 5 7 4 4 4 4 4 6 4 5 4 4 4 4 4 4 4 4 5 4 4 4 4 4 4
4 4 5 6 4 4 4 4 4 4 4 5 4 4 4 4 4 4 4 4 5 4 4 4 4 4 6 4 4 5 4 4 4 4 4 4 4 4 5 4 4 4 4 4 4 4 4 5 4 6 4 4 4 4 4 7 5 4 4 4 4 4 4 4 4 5 4 4 4 4 4 4 6 4 5 4 4 4 4 4 4 4 4 5 7 4 4 4 4 4 4 4 5 4 4 6 4 4 4 4
4 5 4 4 4 7 4 4 4 4 5 4 4 4 4 4 6 4 4 5 4 4 4 4 4 4 4 4 5 4 4 4 4 4 7 4 4 5 4 6 4 4 4 4 4 4 5 4 4 4 4 4 4 4 4 5 4 4 4 4 4 4 6 7 5 4 4 4 4 4 4 4 4 5 4 4 4 4 4 4 4 4 5 4 4 6 4 4 4 4 4 5 7 4 4 4 4 4 4 4
5 4 4 4 4 4 6 4 4 5 4 4 4 7 4 4 4 4 5 4 4 4 4 4 4 4 4 5 4 6 4 4 4 4 4 4 5 4 4 4 4 4 7 4 4 5 4 4 4 4 4 4 6 4 5 4 4 4 4 4 4 4 4 5 4 4 4 4 4 4 4 7 5 4 4 6 4 4 4 4 4 5 4 4 4 4 4 4 4 4 5 4 4 4 4 4 4 4 6 5
4 4 4 4 4 4 4 4 5 4 4 4 4 4 4 4 4 5 4 6 4 7 4 4 4 4 5 4 4 4 4 4 4 4 4 5 4 4 4 4 4 4 6 4 5 4 4 4 4 4 7 4 4 5 4 4 4 4 4 4 4 4 5 4 4 6 4 4 4 4 4 5 4 4 4 4 4 4 4 7 5 4 4 4 4 4 4 4 6 5 4 4 4 4 4 4 4 4 5 4
7 4 4 4 4 4 4 5 4 6 4 4 4 4 4 4 5 4 4 4 4 4 4 4 4 5 4 4 4 7 4 4 6 4 5 4 4 4 4 4 4 4 4 5 4 4 4 4 4 4 4 4 5 4 4 6 4 4 7 4 4 5 4 4 4 4 4 4 4 4 5 4 4 4 4 4 4 4 6 5 4 4 4 4 4 4 4 7 5 4 4 4 4 4 4 4 4 5 4 4
4 4 4 4 4 4 5 4 7 4 4 4 4 4 4 5 4 4 4 4 4 4 6 4 5 4 4 4 4 4 4 4 4 5 4 4 4 7 4 4 4 4 5 4 4 6 4 4 4 4 4 5 4 4 4 4 4 4 4 4 5 4 4 4 4 4 7 4 6 5 4 4 4 4 4 4 4 4 5 4 4 4 4 4 4 4 4 5 4 4 4 6 4 4 4 7 5 4 4 4
4 4 4 4 4 5 4 4 4 4 4 4 6 4 5 4 7 4 4 4 4 4 4 5 4 4 4 4 4 4 4 4 5 4 4 6 4 4 4 4 4 5 4 4 4 7 4 4 4 4 5 4 4 4 4 4 4 4 6 5 4 4 4 4 4 4 4 4 5 4 4 4 4 4 7 4 4 5 4 4 4 6 4 4 4 4 5 4 4 4 4 4 4 4 4 5 4 4 4 4
A A A A A A A A A A A A A A A A A A A A A A A A A A A A A A A A A A A A A A A A A A A A A A A A A A A A A A A A A A A A 2 2 2 2 2 2 2 2 2 2 2 2 2 2 2 2 2 2 2 2 2 2 2 2 2 2 2 2 2 2 2 2 2 2 2 2 2 2 2 2
A A A A A A A A A A A A A A A A A A A A A A A A A A A A A A A A A A A A A A A A A A A A A A A A A A A A A A A A A A A A 2 2 2 2 2 2 2 2 2 2 2 2 2 2 2 2 2 2 2 2 2 2 2 2 2 2 2 2 2 2 2 2 2 2 2 2 2 2 2 2
A A A A A A A A A A A A A A A A A A A A A A A A A A A A A A A A A A A A A A A A A A A A A A A A A A A A A A A A A A A A 2 2 2 2 2 2 2 2 2 2 2 2 2 2 2 2 2 2 2 2 2 2 2 2 2 2 2 2 2 2 2 2 2 2 2 2 2 2 2 2
A A A A A A A A A A A A A A A A A A A A A A A A A A A A A A A A A A A A A A A A A A A A A A A A A A A A A A A A A A A A 2 2 2 2 2 2 2 2 2 2 2 2 2 2 2 2 2 2 2 2 2 2 2 2 2 2 2 2 2 2 2 2 2 2 2 2 2 2 2 2
A A A A A A A A A A A A A A A A A A A A A A A A A A A A A A A A A A A A A A A A A A A A A A A A A A A A A A A A A A A A 2 2 2 2 2 2 2 2 2 2 2 2 2 2 2 2 2 2 2 2 2 2 2 2 2 2 2 2 2 2 2 2 2 2 2 2 2 2 2 2
A A A A A A A A A A A A A A A A A A A A A A A A A A A A A A A A A A A A A A A A A A A A A A A A A A A A A A A A A A A A 2 2 2 2 2 2 2 2 2 2 2 2 2 2 2 2 2 2 2 2 2 2 2 2 2 2 2 2 2 2 2 2 2 2 2 2 2 2 2 2
A A A A A A A A A A A A A A A A A A A A A A A A A A A A A A A A A A A A A A A A A A A A A A A A A A A A A A A A A A A A 2 2 2 2 2 2 2 2 2 2 2 2 2 2 2 2 2 2 2 2 2 2 2 2 2 2 2 2 2 2 2 2 2 2 2 2 2 2 2 2
A A A A A A A A A A A A A A A A A A A A A A A A A A A A A A A A A A A A A A A A A A A A A A A A A A A A A A A A A A A A 2 2 2 2 2 2 2 2 2 2 2 2 2 2 2 2 2 2 2 2 2 2 2 2 2 2 2 2 2 2 2 2 2 2 2 2 2 2 2 2
A A A A A A A A A A A A A A A A A A A A A A A A A A A A A A A A A A A A A A A A A A A A A A A A A A A A A A A A A A A A 2 2 2 2 2 2 2 2 2 2 2 2 2 2 2 2 2 2 2 2 2 2 2 2 2 2 2 2 2 2 2 2 2 2 2 2 2 2 2 2
A A A A A A A A A A A A A A A A A A A A A A A A A A A A A A A A A A A A A A A A A A A A A A A A A A A A A A A A A A A A 2 2 2 2 2 2 2 2 2 2 2 2 2 2 2 2 2 2 2 2 2 2 2 2 2 2 2 2 2 2 2 2 2 2 2 2 2 2 2 2
A A A A A A A A A A A A A A A A A A A A A A A A A A A A A A A A A A A A A A A A A A A A A A A A A A A A A A A A A A A A 2 2 2 2 2 2 2 2 2 2 2 2 2 2 2 2 2 2 2 2 2 2 2 2 2 2 2 2 2 2 2 2 2 2 2 2 2 2 2 2
A A A A A A A A A A A A A A A A A A A A A A A A A A A A A A A A A A A A A A A A A A A A A A A A A A A A A A A A A A A A 2 2 2 2 2 2 2 2 2 2 2 2 2 2 2 2 2 2 2 2 2 2 2 2 2 2 2 2 2 2 2 2 2 2 2 2 2 2 2 2
A A A A A A A A A A A A A A A A A A A A A A A A A A A A A A A A A A A A A A A A A A A A A A A A A A A A A A A A A A A A 2 2 2 2 2 2 2 2 2 2 2 2 2 2 2 2 2 2 2 2 2 2 2 2 2 2 2 2 2 2 2 2 2 2 2 2 2 2 2 2
A A A A A A A A A A A A A A A A A A A A A A A A A A A A A A A A A A A A A A A A A A A A A A A A A A A A A A A A A A A A 2 2 2 2 2 2 2 2 2 2 2 2 2 2 2 2 2 2 2 2 2 2 2 2 2 2 2 2 2 2 2 2 2 2 2 2 2 2 2 2
A A A A A A A A A A A A A A A A A A A A A A A A A A A A A A A A A A A A A A A A A A A A A A A A A A A A A A A A A A A A 2 2 2 2 2 2 2 2 2 2 2 2 2 2 2 2 2 2 2 2 2 2 2 2 2 2 2 2 2 2 2 2 2 2 2 2 2 2 2 2
A A A A A A A A A A A A A A A A A A A A A A A A A A A A A A A A A A A A A A A A A A A A A A A A A A A A A A A A A A A A 2 2 2 2 2 2 2 2 2 2 2 2 2 2 2 2 2 2 2 2 2 2 2 2 2 2 2 2 2 2 2 2 2 2 2 2 2 2 2 2
A A A A A A A A A A A A A A A A A A A A A A A A A A A A A A A A A A A A A A A A A A A A A A A A A A A A A A A A A A A A 2 2 2 2 2 2 2 2 2 2 2 2 2 2 2 2 2 2 2 2 2 2 2 2 2 2 2 2 2 2 2 2 2 2 2 2 2 2 2 2
A A A A A A A A A A A A A A A A A A A A A A A A A A A A A A A A A A A A A A A A A A A A A A A A A A A A A A A A A A A A 2 2 2 2 2 2 2 2 2 2 2 2 2 2 2 2 2 2 2 2 2 2 2 2 2 2 2 2 2 2 2 2 2 2 2 2 2 2 2 2
A A A A A A A A A A A A A A A A A A A A A A A A A A A A A A A A A A A A A A A A A A A A A A A A A A A A A A A A A A A A 2 2 2 2 2 2 2 2 2 2 2 2 2 2 2 2 2 2 2 2 2 2 2 2 2 2 2 2 2 2 2 2 2 2 2 2 2 2 2 2
A A A A A A A A A A A A A A A A A A A A A A A A A A A A A A A A A A A A A A A A A A A A A A A A A A A A A A A A A A A A 2 2 2 2 2 2 2 2 2 2 2 2 2 2 2 2 2 2 2 2 2 2 2 2 2 2 2 2 2 2 2 2 2 2 2 2 2 2 2 2
A A A A A A A A A A A A A A A A A A A A A A A A A A A A A A A A A A A A A A A A A A A A A A A A A A A A A A A A A A A A 2 2 2 2 2 2 2 2 2 2 2 2 2 2 2 2 2 2 2 2 2 2 2 2 2 2 2 2 2 2 2 2 2 2 2 2 2 2 2 2
A A A A A A A A A A A A A A A A A A A A A A A A A A A A A A A A A A A A A A A A A A A A A A A A A A A A A A A A A A A A 2 2 2 2 2 2 2 2 2 2 2 2 2 2 2 2 2 2 2 2 2 2 2 2 2 2 2 2 2 2 2 2 2 2 2 2 2 2 2 2
A A A A A A A A A A A A A A A A A A A A A A A A A A A A A A A A A A A A A A A A A A A A A A A A A A A A A A A A A A A A 2 2 2 2 2 2 2 2 2 2 2 2 2 2 2 2 2 2 2 2 2 2 2 2 2 2 2 2 2 2 2 2 2 2 2 2 2 2 2 2
A A A A A A A A A A A A A A A A A A A A A A A A A A A A A A A A A A A A A A A A A A A A A A A A A A A A A A A A A A A A 2 2 2 2 2 2 2 2 2 2 2 2 2 2 2 2 2 2 2 2 2 2 2 2 2 2 2 2 2 2 2 2 2 2 2 2 2 2 2 2
A A A A A A A A A A A A A A A A A A A A A A A A A A A A A A A A A A A A A A A A A A A A A A A A A A A A A A A A A A A A 2 2 2 2 2 2 2 2 2 2 2 2 2 2 2 2 2 2 2 2 2 2 2 2 2 2 2 2 2 2 2 2 2 2 2 2 2 2 2 2
A A A A A A A A A A A A A A A A A A A A A A A A A A A A A A A A A A A A A A A A A A A A A A A A A A A A A A A A A A A A 2 2 2 2 2 2 2 2 2 2 2 2 2 2 2 2 2 2 2 2 2 2 2 2 2 2 2 2 2 2 2 2 2 2 2 2 2 2 2 2
A A A A A A A A A A A A A A A A A A A A A A A A A A A A A A A A A A A A A A A A A A A A A A A A A A A A A A A A A A A A 2 2 2 2 2 2 2 2 2 2 2 2 2 2 2 2 2 2 2 2 2 2 2 2 2 2 2 2 2 2 2 2 2 2 2 2 2 2 2 2
A A A A A A A A A A A A A A A A A A A A A A A A A A A A A A A A A A A A A A A A A A A A A A A A A A A A A A A A A A A A 2 2 2 2 2 2 2 2 2 2 2 2 2 2 2 2 2 2 2 2 2 2 2 2 2 2 2 2 2 2 2 2 2 2 2 2 2 2 2 2
A 8 8 8 8 8 9 8 8 8 8 8 8 8 8 B 8 9 8 8 8 8 8 8 8 8 8 8 9 8 8 8 B 8 8 8 8 A 8 9 8 8 8 8 8 A A A A A A A A A A 2 2 2 2 2 0 0 0 0 3 0 1 0 0 0 0 0 0 0 0 1 0 0 0 0 2 0 0 3 1 0 0 0 0 0 0 0 0 1 2 0 0 0 0 0
A 8 8 8 8 9 8 8 8 8 8 B 8 8 8 8 9 8 8 8 8 8 8 8 8 8 8 9 B 8 8 8 8 8 8 8 8 A 9 8 8 8 8 8 8 A A A A A A A A 2 2 2 2 2 2 2 3 0 0 0 0 1 0 0 0 0 0 0 0 0 1 0 0 0 0 3 0 0 0 1 0 0 0 0 0 0 0 0 1 2 0 0 0 0 3 0
A 8 8 8 9 8 8 B 8 8 8 8 8 8 8 9 8 8 8 8 8 8 8 8 B 8 9 8 8 8 8 8 8 8 8 8 8 9 8 8 8 B 8 8 8 A A A A A A A A A A 2 2 2 2 2 0 0 0 0 1 0 0 0 0 0 0 0 0 1 0 3 0 0 2 0 0 0 1 0 0 0 0 0 0 0 0 1 2 0 3 0 0 0 0 0
A 8 8 9 8 8 8 8 8 8 8 8 8 8 9 8 8 8 8 8 B 8 8 8 8 9 8 8 8 8 8 8 8 8 8 8 9 B 8 8 8 8 8 8 8 A A A A A A A A 2 2 2 2 2 2 2 0 0 0 1 0 0 0 0 0 0 0 3 1 0 0 0 0 2 0 0 0 1 0 0 0 0 0 0 0 0 1 2 0 0 0 0 0 0 0 1
A 8 9 8 8 8 8 8 8 8 8 8 8 9 8 8 B 8 8 8 8 8 8 8 9 8 8 8 8 8 8 8 8 B 8 9 8 A 8 8 8 8 8 8 8 A A A A A A A A A A 2 2 2 2 2 0 0 1 0 0 0 0 3 0 0 0 1 0 0 0 0 2 0 0 0 1 0 0 0 0 0 3 0 0 1 2 0 0 0 0 0 0 0 1 0
A 9 8 8 8 8 8 8 8 8 8 8 9 8 8 8 8 8 8 8 8 8 8 9 8 8 8 8 8 B 8 8 8 8 9 8 8 A 8 8 8 8 8 8 8 A A A A A A A A 2 2 2 2 2 2 2 0 1 0 3 0 0 0 0 0 0 1 0 0 0 0 2 0 0 0 1 0 0 3 0 0 0 0 0 1 2 0 0 0 0 0 0 0 1 0 0
9 8 8 8 8 8 8 8 B 8 8 9 8 8 8 8 8 8 8 8 8 8 9 8 8 B 8 8 8 8 8 8 8 9 8 8 8 A 8 8 8 8 B 8 9 A A A A A A A A A A 2 2 2 2 2 1 0 0 0 0 0 0 0 0 1 0 0 0 0 2 0 0 0 1 0 0 0 0 0 0 0 0 1 2 0 0 0 0 0 0 0 1 3 0 0
A 8 8 8 B 8 8 8 8 8 9 8 8 8 8 8 8 8 8 8 8 9 8 8 8 8 8 8 8 8 8 8 9 8 8 8 8 A B 8 8 8 8 9 8 A A A A A A A A 2 2 2 2 2 2 2 0 0 0 0 0 0 0 0 1 0 0 0 0 2 3 0 0 1 0 0 0 0 0 0 0 0 1 2 0 0 0 0 0 3 0 1 0 0 0 0
B 8 8 8 8 8 8 8 8 9 8 8 8 8 8 8 8 B 8 8 9 8 8 8 8 8 8 8 8 8 8 9 8 8 B 8 8 A 8 8 8 8 9 8 8 A A A A A A A A A A 2 2 2 2 2 0 0 0 0 0 0 0 1 0 0 3 0 2 0 0 0 1 0 0 0 0 0 0 0 0 1 2 0 0 3 0 0 0 0 1 0 0 0 0 0
A 8 8 8 8 8 8 8 9 8 8 8 8 B 8 8 8 8 8 9 8 8 8 8 8 8 8 8 8 8 9 8 8 8 8 8 8 A 8 8 8 9 8 8 8 A A A A A A A A 2 2 2 2 2 2 2 0 0 0 0 0 0 1 0 0 0 0 2 0 0 0 1 0 0 0 0 0 0 0 0 1 3 0 0 0 0 0 0 0 1 0 0 0 0 0 2
A 8 8 8 8 8 8 9 8 B 8 8 8 8 8 8 8 8 9 8 8 8 8 8 8 8 B 8 8 9 8 8 8 8 8 8 8 A 8 8 9 8 8 B 8 A A A A A A A A A A 2 2 2 2 2 0 0 3 0 0 1 0 0 0 0 2 0 0 0 1 0 0 0 0 0 0 3 0 1 2 0 0 0 0 0 0 0 1 0 0 0 0 0 2 0
A 8 8 8 8 B 9 8 8 8 8 8 8 8 8 8 8 9 8 8 8 8 B 8 8 8 8 8 9 8 8 8 8 8 8 8 8 A 8 9 8 8 8 8 8 A A A A A A A A 2 2 2 2 2 2 2 0 0 0 0 1 0 0 0 0 2 0 0 0 1 0 0 0 3 0 0 0 0 1 2 0 0 0 0 0 0 0 1 0 0 0 0 3 2 0 0
A B 8 8 8 9 8 8 8 8 8 8 8 8 8 8 9 8 B 8 8 8 8 8 8 8 8 9 8 8 8 8 8 8 8 B 8 A 9 8 8 8 8 8 8 A A A A A A A A A A 2 2 2 2 2 0 0 0 1 0 0 0 0 2 0 0 0 1 3 0 0 0 0 0 0 0 1 2 0 0 0 0 0 0 0 1 0 3 0 0 0 2 0 0 1
A 8 8 8 9 8 8 8 8 8 8 8 8 8 B 9 8 8 8 8 8 8 8 8 8 8 9 8 8 8 8 B 8 8 8 8 8 9 8 8 8 8 8 8 8 A A A A A A A A 2 2 2 2 2 2 2 0 0 1 0 0 0 0 2 0 3 0 1 0 0 0 0 0 0 0 0 1 2 0 0 0 0 0 0 3 1 0 0 0 0 0 2 0 0 1 0
A A A 9 A A A A A A B A A A 9 A A A A A A A A A A 9 A B A A A A A A A A 9 A A A A A A A B A A A A A A A A A A 2 2 2 2 2 0 1 0 0 0 3 2 0 0 0 1 0 0 0 0 0 0 0 0 1 2 0 0 0 3 0 0 0 1 0 0 0 0 0 2 0 0 1 0 0
A 8 9 8 8 8 B 8 8 8 8 8 8 9 8 8 8 8 8 8 8 8 8 B 9 8 8 8 8 8 8 8 8 8 8 9 8 A 8 8 B 8 8 8 8 A A A A A A A A 2 2 2 2 2 2 2 1 3 0 0 0 2 0 0 0 1 0 0 0 0 0 0 0 0 1 2 3 0 0 0 0 0 0 1 0 0 0 0 0 2 0 0 1 0 0 3
A 9 B 8 8 8 8 8 8 8 8 8 9 8 8 8 8 8 8 B 8 8 8 9 8 8 8 8 8 8 8 8 8 8 9 8 B A 8 8 8 8 8 8 8 A A A A A A A A A A 2 2 2 2 2 0 0 0 0 2 0 0 0 1 0 0 0 0 0 0 0 3 1 2 0 0 0 0 0 0 0 1 0 0 0 0 0 2 0 0 1 0 0 0 0
9 8 8 8 8 8 8 8 8 8 8 9 8 8 8 B 8 8 8 8 8 8 9 8 8 8 8 8 8 8 8 8 B 9 8 8 8 A 8 8 8 8 8 8 9 A A A A A A A A 2 2 2 2 2 2 2 0 0 0 2 0 0 0 1 0 0 0 0 3 0 0 0 1 2 0 0 0 0 0 0 0 1 0 0 0 0 0 3 0 0 1 0 0 0 0 0
A 8 8 8 8 8 8 8 8 8 9 B 8 8 8 8 8 8 8 8 8 9 8 8 8 8 8 8 B 8 8 8 9 8 8 8 8 A 8 8 8 8 8 9 8 A A A A A A A A A A 2 2 2 2 2 0 0 2 0 0 0 1 0 3 0 0 0 0 0 0 1 2 0 0 0 0 0 0 0 1 0 0 3 0 0 2 0 0 1 0 0 0 0 0 0
A 8 8 8 8 8 8 B 8 9 8 8 8 8 8 8 8 8 8 8 9 8 8 8 B 8 8 8 8 8 8 9 8 8 8 8 8 A 8 8 8 B 9 8 8 A A A A A A A A 2 2 2 2 2 2 2 0 2 0 0 3 1 0 0 0 0 0 0 0 0 1 2 0 0 0 0 0 0 0 1 0 0 0 0 0 2 0 0 1 0 0 0 0 0 0 0
A 8 8 B 8 8 8 8 9 8 8 8 8 8 8 8 8 8 8 9 B 8 8 8 8 8 8 8 8 8 9 8 8 8 8 8 8 B 8 8 8 9 8 8 8 A A A A A A A A A A 2 2 2 2 2 3 0 0 0 1 0 0 0 0 0 0 0 0 1 2 0 0 0 0 3 0 0 1 0 0 0 0 0 2 0 0 1 0 0 0 0 0 0 3 0
A 8 8 8 8 8 8 9 8 8 8 8 8 8 8 8 B 8 9 8 8 8 8 8 8 8 8 8 8 9 8 8 8 B 8 8 8 A 8 8 9 8 8 8 8 A A A A A A A A 2 2 2 2 2 2 2 0 0 0 1 0 0 0 0 0 0 0 0 1 2 0 3 0 0 0 0 0 1 0 0 0 0 0 2 0 0 1 0 0 0 3 0 0 0 0 1
A 8 8 8 8 8 9 8 8 8 8 8 B 8 8 8 8 9 8 8 8 8 8 8 8 8 8 8 9 B 8 8 8 8 8 8 8 A 8 9 8 8 8 8 8 A A A A A A A A A A 2 2 2 2 2 0 0 1 0 0 0 0 0 0 0 0 1 2 0 0 0 0 0 0 0 1 0 0 0 0 0 2 0 0 1 3 0 0 0 0 0 0 0 1 0
A 8 8 8 8 9 8 8 B 8 8 8 8 8 8 8 9 8 8 8 8 8 8 8 8 B 8 9 8 8 8 8 8 8 8 8 8 A 9 8 8 8 B 8 8 A A A A A A A A 2 2 2 2 2 2 2 0 1 0 0 0 0 0 3 0 0 1 2 0 0 0 0 0 0 0 1 0 0 0 0 0 2 3 0 1 0 0 0 0 0 0 0 0 1 0 2
A 8 8 8 9 8 8 8 8 8 8 8 8 8 8 9 8 8 8 8 8 B 8 8 8 8 9 8 8 8 8 8 8 8 8 8 8 9 B 8 8 8 8 8 8 A A A A A A A A A A 2 2 2 2 2 1 0 0 3 0 0 0 0 0 1 2 0 0 0 0 0 0 0 1 0 0 0 3 0 2 0 0 1 0 0 0 0 0 0 0 0 1 0 2 0
B 8 8 9 8 8 8 8 8 8 8 8 8 8 9 8 8 B 8 8 8 8 8 8 8 9 8 8 8 8 8 8 8 8 B 8 9 A 8 8 8 8 8 8 8 A A A A A A A A 2 2 2 2 2 2 2 0 0 0 0 0 0 0 0 1 2 0 0 0 0 0 0 0 1 3 0 0 0 0 2 0 0 1 0 0 0 0 0 0 0 0 1 0 3 0 0
A 8 9 8 8 8 8 8 8 8 8 8 8 9 8 8 8 8 8 8 8 8 8 8 9 8 8 8 8 8 B 8 8 8 8 9 8 A 8 8 8 8 8 8 8 A A A A A A A A A A 2 2 2 2 2 0 0 0 0 0 0 0 1 2 0 0 0 0 0 3 0 1 0 0 0 0 0 2 0 0 1 0 0 0 0 0 0 0 3 1 0 2 0 0 0
A 9 8 8 8 8 8 8 8 B 8 8 9 8 8 8 8 8 8 8 8 8 8 9 8 8 B 8 8 8 8 8 8 8 9 8 8 A 8 8 8 8 8 B 8 A A A A A A A A 2 2 2 2 2 2 2 0 0 0 0 0 0 1 2 0 0 3 0 0 0 0 1 0 0 0 0 0 2 0 0 1 0 0 0 0 3 0 0 0 1 0 2 0 0 0 0
9 8 8 8 8 B 8 8 8 8 8 9 8 8 8 8 8 8 8 8 8 8 9 8 8 8 8 8 8 8 8 8 8 9 8 8 8 A 8 B 8 8 8 8 9 A A A A A A A A A A 2 2 2 2 2 0 0 0 0 0 1 3 0 0 0 0 0 0 0 1 0 0 0 0 0 2 0 0 1 0 3 0 0 0 0 0 0 1 0 2 0 0 0 0 0
A B 8 8 8 8 8 8 8 8 9 8 8 8 8 8 8 8 B 8 8 9 8 8 8 8 8 8 8 8 8 8 9 8 8 B 8 A 8 8 8 8 8 9 8 A A A A A A A A 2 2 2 2 2 2 2 0 0 3 0 1 2 0 0 0 0 0 0 0 1 0 0 0 0 0 2 0 3 1 0 0 0 0 0 0 0 0 1 0 2 0 0 0 0 0 0
A 8 8 8 8 8 8 8 8 9 8 8 8 8 B 8 8 8 8 8 9 8 8 8 8 8 8 8 8 8 8 9 8 8 8 8 8 A 8 8 8 8 9 8 8 A A A A A A A A A A 2 2 2 2 2 0 0 0 1 2 0 0 0 0 0 0 0 1 0 0 0 0 3 2 0 0 1 0 0 0 0 0 0 0 0 1 0 2 0 0 0 3 0 0 1
A 8 8 8 8 8 8 8 9 8 B 8 8 8 8 8 8 8 8 9 8 8 8 8 8 8 8 B 8 8 9 8 8 8 8 8 8 A 8 8 8 9 8 8 B A A A A A A A A 2 2 2 2 2 2 2 0 0 1 2 0 0 0 0 0 0 0 1 0 3 0 0 0 2 0 0 1 0 0 0 0 0 0 0 0 1 0 2 3 0 0 0 0 0 1 0
A 8 8 8 8 8 B 9 8 8 8 8 8 8 8 8 8 8 9 8 8 8 8 B 8 8 8 8 8 9 8 8 8 8 8 8 8 A 8 8 9 8 8 8 8 A A A A A A A A A A 2 2 2 2 2 0 1 2 0 0 0 0 0 0 3 1 0 0 0 0 0 2 0 0 1 0 0 0 0 0 0 0 0 1 0 2 0 0 0 0 0 0 1 0 0
A 8 B 8 8 8 9 8 8 8 8 8 8 8 8 8 8 9 8 B 8 8 8 8 8 8 8 8 9 8 8 8 8 8 8 8 B A 8 9 8 8 8 8 8 A A A A A A A A 2 2 2 2 2 2 2 1 2 0 0 0 3 0 0 0 1 0 0 0 0 0 2 0 0 1 0 0 0 0 0 3 0 0 1 0 2 0 0 0 0 0 0 1 0 0 0
A 8 8 8 8 9 8 8 8 8 8 8 8 8 8 B 9 8 8 8 8 8 8 8 8 8 8 9 8 8 8 8 B 8 8 8 8 A 9 8 8 8 8 8 8 A A A A A A A A A A 2 2 2 2 2 2 3 0 0 0 0 0 0 1 0 0 0 0 0 2 0 0 1 0 0 3 0 0 0 0 0 1 0 2 0 0 0 0 0 0 1 0 0 0 3
A 8 8 8 9 8 8 8 8 8 8 B 8 8 8 9 8 8 8 8 8 8 8 8 8 8 9 8 B 8 8 8 8 8 8 8 8 9 8 8 8 8 8 8 8 A A A A A A A A 2 2 2 2 2 2 2 0 0 0 0 0 0 0 1 0 0 0 0 0 2 0 0 1 0 0 0 0 0 0 0 0 1 0 2 0 0 0 0 0 0 1 3 0 0 0 0
A 8 8 9 8 8 8 B 8 8 8 8 8 8 9 8 8 8 8 8 8 8 8 8 B 9 8 8 8 8 8 8 8 8 8 8 9 A 8 8 8 B 8 8 8 A A A A A A A A A A 2 2 2 2 2 0 0 0 0 0 0 1 0 0 0 0 0 3 0 0 1 0 0 0 0 0 0 0 0 1 0 2 0 0 0 0 3 0 1 0 0 0 0 0 0
A 8 9 B 8 8 8 8 8 8 8 8 8 9 8 8 8 8 8 8 B 8 8 8 9 8 8 8 8 8 8 8 8 8 8 9 8 B 8 8 8 8 8 8 8 A A A A A A A A 2 2 2 2 2 2 2 0 0 0 0 0 1 0 0 3 0 0 2 0 0 1 0 0 0 0 0 0 0 0 1 0 2 0 3 0 0 0 0 1 0 0 0 0 0 0 2
A 9 8 8 8 8 8 8 8 8 8 8 9 8 8 8 B 8 8 8 8 8 8 9 8 8 8 8 8 8 8 8 8 B 9 8 8 A 8 8 8 8 8 8 8 A A A A A A A A A A 2 2 2 2 2 0 0 0 0 1 0 0 0 0 0 2 0 0 1 0 0 0 0 0 0 0 0 1 3 2 0 0 0 0 0 0 1 0 0 0 0 0 0 2 0
9 8 8 8 8 8 8 8 8 8 8 9 B 8 8 8 8 8 8 8 8 8 9 8 8 8 8 8 8 B 8 8 8 9 8 8 8 A 8 8 8 8 8 8 9 A A A A A A A A 2 2 2 2 2 2 2 3 0 0 1 0 0 0 0 0 2 0 0 1 0 0 0 0 0 0 3 0 1 0 2 0 0 0 0 0 0 1 0 0 0 0 0 0 2 3 1
