100 100
3 3 3 3 3 3 3 3 3 3 3 3 3 3 3 3 3 3 3 3 3 3 3 3 3 3 3 3 3 3 3 3 3 6 6 6 6 6 6 6 6 6 6 6 6 6 6 6 6 6 6 6 6 6 6 6 6 6 6 6 6 6 6 6 6 6 B 9 8 8 8 A 8 9 9 8 A A 8 8 9 A 8 B 8 8 A 9 A 8 8 A 8 8 9 9 9 9 9 9
3 0 0 0 0 1 1 1 1 1 3 0 0 0 0 0 0 0 0 0 0 3 0 0 0 0 0 0 0 0 0 0 3 4 4 4 5 5 5 5 5 5 5 4 4 7 4 4 4 4 4 4 4 4 4 4 4 4 7 4 4 4 4 6 6 6 B 9 8 8 9 8 8 9 9 A 8 8 8 9 9 9 8 B 8 8 A 9 9 8 8 8 8 8 9 9 8 A 8 8
3 0 0 0 0 0 0 0 0 3 0 0 0 0 0 0 0 0 0 0 3 0 0 0 0 0 0 0 2 2 2 3 2 4 4 4 5 5 5 5 5 5 5 4 7 4 6 6 6 6 6 6 6 6 4 4 4 7 4 4 4 4 4 5 5 5 B 9 8 8 9 8 8 A 9 8 8 8 8 9 9 9 8 B A 8 A A A A A 8 8 8 9 A 8 9 8 8
3 0 0 0 0 0 0 0 3 0 0 0 0 0 0 1 1 1 0 3 0 0 0 0 0 0 0 0 0 0 3 0 0 4 4 4 4 4 4 4 4 4 4 7 4 4 6 6 6 6 6 6 6 6 4 4 7 4 4 4 4 4 4 6 6 6 B 9 8 8 8 A 8 9 9 8 8 8 8 8 9 9 A B 8 8 8 9 9 8 8 8 8 A 9 9 9 9 9 9
3 0 0 0 0 1 1 3 1 1 1 0 0 0 0 0 0 0 3 0 0 0 0 0 0 0 0 0 2 3 2 2 2 4 4 4 5 5 5 5 5 5 7 4 4 4 4 4 4 4 4 4 4 4 4 7 4 4 4 4 4 4 4 5 5 5 B 9 8 A 8 8 8 9 9 8 8 8 8 8 A 9 8 B 8 8 8 9 9 8 8 A 8 8 9 9 8 8 8 8
3 0 0 0 0 1 3 1 1 1 1 0 0 0 0 0 0 3 0 0 2 2 2 2 2 0 0 0 3 0 0 0 0 4 4 4 5 5 5 5 5 7 5 4 4 4 4 4 4 4 4 4 4 4 7 4 4 5 5 5 5 5 4 6 6 6 B A 8 8 9 8 8 9 9 8 8 8 A 9 9 9 8 B 8 8 8 9 9 A 8 8 8 8 9 9 8 9 8 8
3 0 0 0 0 3 0 0 0 0 0 0 0 0 0 0 3 0 0 0 0 0 0 0 0 0 0 3 2 2 2 2 2 4 4 4 4 4 4 4 7 4 4 4 4 4 4 4 4 4 4 4 4 7 4 4 4 4 4 4 4 4 4 5 5 5 B 9 8 8 9 A 8 9 9 8 A 8 8 9 9 A 8 B 8 8 A A 9 8 8 A 8 8 9 9 9 9 9 9
3 0 0 0 3 0 0 0 0 0 0 0 0 0 0 3 0 0 0 0 0 0 0 0 0 0 3 0 0 0 0 0 0 4 4 4 5 5 5 7 5 5 5 4 4 4 4 4 4 4 4 4 7 4 4 4 4 4 4 4 4 4 4 6 6 6 B 9 8 8 8 8 8 9 A 8 8 8 8 8 9 9 8 B 8 A 8 9 9 8 8 8 8 8 9 9 A 8 8 8
3 0 0 3 0 1 1 1 1 1 1 0 0 0 3 0 0 0 0 0 0 0 0 0 0 3 0 0 2 2 2 2 2 4 4 4 5 5 7 5 5 5 5 4 4 4 6 6 6 6 6 7 6 6 4 4 4 4 4 4 4 4 4 5 5 5 B 9 8 8 8 8 A 9 9 8 8 8 8 8 9 9 8 B 8 8 A A A A A 8 8 8 A 9 8 8 8 8
3 0 3 0 0 1 1 1 1 1 1 0 0 3 0 1 1 1 0 0 0 0 0 0 3 0 0 0 0 0 0 0 0 4 4 4 4 7 4 4 4 4 4 4 4 4 6 6 6 6 7 6 6 6 4 4 4 4 4 4 4 4 4 6 6 6 B 9 8 8 A 8 8 9 9 8 8 8 8 9 9 A 8 B 8 8 8 9 9 8 8 8 A 8 9 9 9 9 9 9
3 3 0 0 0 0 0 0 0 0 0 0 3 0 0 0 0 0 0 0 2 2 2 2 2 0 0 0 2 2 2 2 2 6 6 6 6 6 6 6 6 6 6 6 6 6 6 6 6 6 6 6 6 6 6 6 6 6 6 6 6 6 6 6 6 6 B 9 A 8 9 8 8 9 9 8 8 8 8 A 9 9 8 B 8 8 8 9 9 8 A 8 8 8 9 9 8 9 8 8
3 0 0 0 0 0 0 0 0 0 0 3 0 0 0 0 0 0 0 0 0 0 3 0 0 0 0 0 0 0 0 0 0 4 4 7 5 5 5 5 5 5 5 4 4 4 4 4 7 4 4 4 4 4 4 4 4 4 4 4 4 7 4 6 6 6 B 9 8 8 8 8 8 9 9 8 8 A 8 8 9 9 8 B 8 8 8 9 A 8 8 8 8 8 9 9 8 8 8 A
3 0 0 0 0 1 1 1 1 1 3 0 0 0 0 0 0 0 0 0 0 3 0 0 0 0 0 0 2 2 2 2 3 4 7 4 4 4 4 4 4 4 4 4 4 4 4 7 4 4 4 4 4 4 4 4 4 4 4 4 7 4 4 5 5 5 B 9 8 8 8 A 8 9 9 A A 8 8 8 9 A 8 B 8 8 A 9 9 8 8 A 8 8 9 9 9 9 9 9
3 0 0 0 0 1 1 1 1 3 1 0 0 0 0 0 0 0 0 0 3 0 0 0 0 0 0 0 0 0 0 3 0 7 4 4 5 5 5 5 5 5 5 4 4 4 7 4 4 4 4 4 4 4 4 4 4 4 4 7 4 4 4 6 6 6 B 9 8 8 9 8 8 A 9 8 8 8 8 9 9 9 8 B A 8 8 9 9 8 8 8 8 8 9 A 8 9 8 8
3 0 0 0 0 0 0 0 3 0 0 0 0 0 0 0 0 0 0 3 0 0 0 0 0 0 0 0 2 2 3 2 2 4 4 4 5 5 5 5 5 5 5 4 4 7 6 6 6 6 6 6 6 6 4 4 4 4 7 4 4 4 4 5 5 5 B 9 8 8 9 A 8 9 9 8 8 8 8 9 9 9 A B 8 8 A A A A A 8 8 A 9 9 8 9 8 8
3 0 0 0 0 0 0 3 0 0 0 0 0 0 0 1 1 1 3 0 2 2 2 2 2 0 0 0 0 3 0 0 0 4 4 4 4 4 4 4 4 4 4 4 7 4 6 6 6 6 6 6 6 6 4 4 4 7 5 5 5 5 4 6 6 6 B 9 8 A 8 8 8 9 9 8 8 8 8 8 A 9 8 B 8 8 8 9 9 8 8 A 8 8 9 9 9 9 9 9
3 0 0 0 0 1 3 1 1 1 1 0 0 0 0 0 0 3 0 0 0 0 0 0 0 0 0 0 3 2 2 2 2 4 4 4 5 5 5 5 5 5 5 7 4 4 4 4 4 4 4 4 4 4 4 4 7 4 4 4 4 4 4 5 5 5 B B B B B B B B B B B B B B B B B B B B B B B B B B B B B B B B B B
3 0 0 0 0 3 1 1 1 1 1 0 0 0 0 0 3 0 0 0 0 0 0 0 0 0 0 3 0 0 0 0 0 4 4 4 5 5 5 5 5 5 7 4 4 4 4 4 4 4 4 4 4 4 4 7 4 4 4 4 4 4 4 6 6 6 B 9 8 8 9 8 8 9 9 8 A 8 8 9 9 9 8 B 8 8 8 A 9 8 8 8 8 8 9 9 8 9 A 8
3 0 0 0 3 0 0 0 0 0 0 0 0 0 0 3 0 0 0 0 0 0 0 0 0 0 3 0 2 2 2 2 2 4 4 4 4 4 4 4 4 7 4 4 4 4 4 4 4 4 4 4 4 4 7 4 4 4 4 4 4 4 4 5 5 5 B 9 8 8 9 A 8 9 A 8 A 8 8 9 9 A 8 B 8 A A 9 9 8 8 A 8 8 9 9 9 9 9 9
3 0 0 3 0 0 0 0 0 0 0 0 0 0 3 0 0 0 0 0 0 0 0 0 0 3 0 0 0 0 0 0 0 4 4 4 5 5 5 5 7 5 5 4 4 4 4 4 4 4 4 4 4 7 4 4 4 4 4 4 4 4 4 6 6 6 B 9 8 8 8 8 A 9 9 8 8 8 8 8 9 9 8 B 8 8 8 9 9 8 8 8 8 8 A 9 8 8 8 8
3 0 3 0 0 1 1 1 1 1 1 0 0 3 0 0 0 0 0 0 2 2 2 2 2 0 0 0 2 2 2 2 2 6 6 6 6 6 6 6 6 6 6 6 6 6 6 6 6 6 6 6 6 6 6 6 6 6 6 6 6 6 6 6 6 6 B 9 8 8 A 8 8 9 9 8 8 8 8 8 9 A 8 B 8 8 A A A A A 8 A 8 9 9 8 8 8 8
3 3 0 0 0 1 1 1 1 1 1 0 3 0 0 1 1 1 0 0 0 0 0 3 0 0 0 0 0 0 0 0 0 4 4 4 4 4 7 4 4 4 4 4 4 4 6 6 6 6 6 7 6 6 4 4 4 4 4 4 4 4 4 6 6 6 B 9 A 8 9 8 8 9 9 8 8 8 8 A 9 9 8 B 8 8 8 9 9 8 A 8 8 8 9 9 9 9 9 9
3 0 0 0 0 0 0 0 0 0 0 3 0 0 0 0 0 0 0 0 0 0 3 0 0 0 0 0 2 2 2 2 2 4 4 4 5 7 5 5 5 5 5 4 4 4 4 4 4 4 7 4 4 4 4 4 4 4 4 4 4 4 4 5 5 5 B 9 8 8 9 8 8 9 9 8 8 A 8 9 9 9 8 B 8 8 8 9 A 8 8 8 8 8 9 9 8 9 8 A
3 0 0 0 0 0 0 0 0 0 3 0 0 0 0 0 0 0 0 0 0 3 0 0 0 0 0 0 0 0 0 0 3 4 4 4 7 5 5 5 5 5 5 4 4 4 4 4 4 7 4 4 4 4 4 4 4 4 4 4 4 4 7 6 6 6 B 9 8 8 8 8 8 9 9 A 8 8 8 8 9 9 8 B 8 8 A 9 9 8 8 8 8 8 9 9 8 A 8 8
3 0 0 0 0 1 1 1 1 3 1 0 0 0 0 0 0 0 0 0 3 0 0 0 0 0 0 0 2 2 2 3 2 4 4 7 4 4 4 4 4 4 4 4 4 4 4 4 7 4 4 4 4 4 4 4 4 4 4 4 4 7 4 5 5 5 B 9 8 8 8 A 8 A 9 8 A 8 8 8 9 A 8 B A 8 A 9 9 8 8 A 8 8 9 9 9 9 9 9
3 0 0 0 0 1 1 1 3 1 1 0 0 0 0 0 0 0 0 3 2 2 2 2 2 0 0 0 0 0 3 0 0 4 7 4 5 5 5 5 5 5 5 4 4 4 4 7 4 4 4 4 4 4 4 4 4 5 5 5 7 5 4 6 6 6 B 9 8 8 9 A 8 9 9 8 8 8 8 9 9 9 A B 8 8 8 9 9 8 8 8 8 A 9 9 8 9 8 8
3 0 0 0 0 0 0 3 0 0 0 0 0 0 0 0 0 0 3 0 0 0 0 0 0 0 0 0 2 3 2 2 2 7 4 4 5 5 5 5 5 5 5 4 4 4 7 6 6 6 6 6 6 6 4 4 4 4 4 7 4 4 4 5 5 5 B 9 8 A 9 8 8 9 9 8 8 8 8 9 A 9 8 B 8 8 A A A A A A 8 8 9 9 8 9 8 8
3 0 0 0 0 0 3 0 0 0 0 0 0 0 0 1 1 3 0 0 0 0 0 0 0 0 0 0 3 0 0 0 0 4 4 4 4 4 4 4 4 4 4 4 4 7 6 6 6 6 6 6 6 6 4 4 4 4 7 4 4 4 4 6 6 6 B A 8 8 8 8 8 9 9 8 8 8 A 8 9 9 8 B 8 8 8 9 9 A 8 8 8 8 9 9 9 9 9 9
3 0 0 0 0 3 1 1 1 1 1 0 0 0 0 0 3 0 0 0 0 0 0 0 0 0 0 3 2 2 2 2 2 4 4 4 5 5 5 5 5 5 5 4 7 4 4 4 4 4 4 4 4 4 4 4 4 7 4 4 4 4 4 5 5 5 B 9 8 8 8 8 8 9 9 8 A 8 8 8 9 9 8 B 8 8 8 A 9 8 8 8 8 8 9 9 8 8 A 8
3 0 0 0 3 1 1 1 1 1 1 0 0 0 0 3 0 0 0 0 0 0 0 0 0 0 3 0 0 0 0 0 0 4 4 4 5 5 5 5 5 5 5 7 4 4 4 4 4 4 4 4 4 4 4 4 7 4 4 4 4 4 4 6 6 6 B 9 8 8 9 8 8 9 A 8 8 8 8 9 9 9 8 B 8 A 8 9 9 8 8 8 8 8 9 9 A 9 8 8
3 0 0 3 0 0 0 0 0 0 0 0 0 0 3 0 0 0 0 0 2 2 2 2 2 3 0 0 2 2 2 2 2 6 6 6 6 6 6 6 6 6 6 6 6 6 6 6 6 6 6 6 6 6 6 6 6 6 6 6 6 6 6 6 6 6 B 9 8 8 9 A A 9 9 8 A 8 8 9 9 A 8 B 8 8 A 9 9 8 8 A 8 8 9 9 9 9 9 9
3 0 3 0 0 0 0 0 0 0 0 0 0 3 0 0 0 0 0 0 0 0 0 0 3 0 0 0 0 0 0 0 0 4 4 4 5 5 5 5 5 7 5 4 4 4 4 4 4 4 4 4 4 4 7 4 4 4 4 4 4 4 4 6 6 6 B 9 8 8 A 8 8 9 9 8 8 8 8 8 9 A 8 B 8 8 8 9 9 8 8 8 A 8 9 9 8 8 8 8
3 3 0 0 0 1 1 1 1 1 1 0 3 0 0 0 0 0 0 0 0 0 0 3 0 0 0 0 2 2 2 2 2 4 4 4 5 5 5 5 7 5 5 4 4 4 6 6 6 6 6 6 6 7 4 4 4 4 4 4 4 4 4 5 5 5 B 9 A 8 8 8 8 9 9 8 8 8 8 A 9 9 8 B 8 8 A A A A A 8 8 8 9 9 8 8 8 8
3 0 0 0 0 1 1 1 1 1 1 3 0 0 0 1 1 1 0 0 0 0 3 0 0 0 0 0 0 0 0 0 0 4 4 4 4 4 4 7 4 4 4 4 4 4 6 6 6 6 6 6 7 6 4 4 4 4 4 4 4 4 4 6 6 6 B B B B B B B B B B B B B B B B B B B B B B B B B B B B 9 9 9 9 9 9
3 0 0 0 0 0 0 0 0 0 3 0 0 0 0 0 0 0 0 0 0 3 0 0 0 0 0 0 2 2 2 2 3 4 4 4 5 5 7 5 5 5 5 4 4 4 4 4 4 4 4 7 4 4 4 4 4 4 4 4 4 4 4 5 5 5 B 9 8 8 9 8 8 9 9 A 8 8 8 9 9 9 8 B 8 8 A 9 9 8 8 8 8 8 9 9 8 A 8 8
3 0 0 0 0 0 0 0 0 3 0 0 0 0 0 0 0 0 0 0 2 2 2 2 2 0 0 0 0 0 0 3 0 4 4 4 5 7 5 5 5 5 5 4 4 4 4 4 4 4 7 4 4 4 4 4 4 5 5 5 5 5 4 6 6 6 B 9 8 8 8 8 8 A 9 8 8 8 8 8 9 9 8 B A 8 8 9 9 8 8 8 8 8 9 A 8 8 8 8
3 0 0 0 0 1 1 1 3 1 1 0 0 0 0 0 0 0 0 3 0 0 0 0 0 0 0 0 2 2 3 2 2 4 4 4 7 4 4 4 4 4 4 4 4 4 4 4 4 7 4 4 4 4 4 4 4 4 4 4 4 4 7 5 5 5 B 9 8 8 8 A 8 9 9 8 A 8 8 8 9 A A B 8 8 A 9 9 8 8 A 8 A 9 9 9 9 9 9
3 0 0 0 0 1 1 3 1 1 1 0 0 0 0 0 0 0 3 0 0 0 0 0 0 0 0 0 0 3 0 0 0 4 4 7 5 5 5 5 5 5 5 4 4 4 4 4 7 4 4 4 4 4 4 4 4 4 4 4 4 7 4 6 6 6 B 9 8 A 9 8 8 9 9 8 8 8 8 9 A 9 8 B 8 8 8 9 9 8 8 A 8 8 9 9 8 9 8 8
3 0 0 0 0 0 3 0 0 0 0 0 0 0 0 0 0 3 0 0 0 0 0 0 0 0 0 0 3 2 2 2 2 4 7 4 5 5 5 5 5 5 5 4 4 4 6 7 6 6 6 6 6 6 4 4 4 4 4 4 7 4 4 5 5 5 B A 8 8 9 8 8 9 9 8 8 8 A 9 9 9 8 B 8 8 A A A A A 8 8 8 9 9 8 9 8 8
3 0 0 0 0 3 0 0 0 0 0 0 0 0 0 1 3 1 0 0 0 0 0 0 0 0 0 3 0 0 0 0 0 7 4 4 4 4 4 4 4 4 4 4 4 4 7 6 6 6 6 6 6 6 4 4 4 4 4 7 4 4 4 6 6 6 B 9 8 8 8 8 8 9 9 8 A 8 8 8 9 9 8 B 8 8 8 A 9 8 8 8 8 8 9 9 9 9 9 9
3 0 0 0 3 1 1 1 1 1 1 0 0 0 0 3 0 0 0 0 2 2 2 2 2 0 3 0 2 2 2 2 2 6 6 6 6 6 6 6 6 6 6 6 6 6 6 6 6 6 6 6 6 6 6 6 6 6 6 6 6 6 6 6 6 6 B 9 8 8 8 8 8 9 A 8 8 8 8 8 9 9 8 B 8 A 8 9 9 8 8 8 8 8 9 9 A 8 8 8
3 0 0 3 0 1 1 1 1 1 1 0 0 0 3 0 0 0 0 0 0 0 0 0 0 3 0 0 0 0 0 0 0 4 4 4 5 5 5 5 5 5 5 4 7 4 4 4 4 4 4 4 4 4 4 4 4 7 4 4 4 4 4 6 6 6 B 9 8 8 9 8 A 9 9 8 8 8 8 9 9 9 8 B 8 8 8 9 9 8 8 8 8 8 A 9 8 9 8 8
3 0 3 0 0 0 0 0 0 0 0 0 0 3 0 0 0 0 0 0 0 0 0 0 3 0 0 0 2 2 2 2 2 4 4 4 4 4 4 4 4 4 4 7 4 4 4 4 4 4 4 4 4 4 4 4 7 4 4 4 4 4 4 5 5 5 B 9 8 8 A A 8 9 9 8 A 8 8 9 9 A 8 B 8 8 A 9 9 8 8 A A 8 9 9 9 9 9 9
3 3 0 0 0 0 0 0 0 0 0 0 3 0 0 0 0 0 0 0 0 0 0 3 0 0 0 0 0 0 0 0 0 4 4 4 5 5 5 5 5 5 7 4 4 4 4 4 4 4 4 4 4 4 4 7 4 4 4 4 4 4 4 6 6 6 B 9 A 8 8 8 8 9 9 8 8 8 8 A 9 9 8 B 8 8 8 9 9 8 A 8 8 8 9 9 8 8 8 8
3 0 0 0 0 1 1 1 1 1 1 3 0 0 0 0 0 0 0 0 0 0 3 0 0 0 0 0 2 2 2 2 2 4 4 4 5 5 5 5 5 7 5 4 4 4 6 6 6 6 6 6 6 6 7 4 4 4 4 4 4 4 4 5 5 5 B 9 8 8 8 8 8 9 9 8 8 A 8 8 9 9 8 B 8 8 A A A A A 8 8 8 9 9 8 8 8 A
3 0 0 0 0 1 1 1 1 1 3 0 0 0 0 1 1 1 0 0 2 2 2 2 2 0 0 0 0 0 0 0 3 4 4 4 4 4 4 4 7 4 4 4 4 4 6 6 6 6 6 6 6 7 4 4 4 5 5 5 5 5 4 6 6 6 B 9 8 8 9 8 8 9 9 A 8 8 8 9 9 9 8 B 8 8 A 9 9 8 8 8 8 8 9 9 9 9 9 9
3 0 0 0 0 0 0 0 0 3 0 0 0 0 0 0 0 0 0 0 3 0 0 0 0 0 0 0 2 2 2 3 2 4 4 4 5 5 5 7 5 5 5 4 4 4 4 4 4 4 4 4 7 4 4 4 4 4 4 4 4 4 4 5 5 5 B 9 8 8 9 8 8 A 9 8 8 8 8 9 9 9 8 B A 8 8 9 9 8 8 8 8 8 9 A 8 9 8 8
3 0 0 0 0 0 0 0 3 0 0 0 0 0 0 0 0 0 0 3 0 0 0 0 0 0 0 0 0 0 3 0 0 4 4 4 5 5 7 5 5 5 5 4 4 4 4 4 4 4 4 7 4 4 4 4 4 4 4 4 4 4 4 6 6 6 B 9 8 8 8 A 8 9 9 8 8 8 8 8 9 9 A B 8 8 8 9 9 8 8 8 8 A 9 9 8 8 8 8
3 0 0 0 0 1 1 3 1 1 1 0 0 0 0 0 0 0 3 0 0 0 0 0 0 0 0 0 2 3 2 2 2 4 4 4 4 7 4 4 4 4 4 4 4 4 4 4 4 4 7 4 4 4 4 4 4 4 4 4 4 4 4 5 5 5 B 9 8 A 8 A 8 9 9 8 A 8 8 8 A A 8 B 8 8 A 9 9 8 8 A 8 8 9 9 9 9 9 9
3 0 0 0 0 1 3 1 1 1 1 0 0 0 0 0 0 3 0 0 0 0 0 0 0 0 0 0 3 0 0 0 0 4 4 4 7 5 5 5 5 5 5 4 4 4 4 4 4 7 4 4 4 4 4 4 4 4 4 4 4 4 7 6 6 6 B A 8 8 9 8 8 9 9 8 8 8 A 9 9 9 8 B 8 8 8 9 9 A 8 8 8 8 9 9 8 9 8 8
3 0 0 0 0 3 0 0 0 0 0 0 0 0 0 0 3 0 0 0 2 2 2 2 2 0 0 3 2 2 2 2 2 6 6 6 6 6 6 6 6 6 6 6 6 6 6 6 6 6 6 6 6 6 6 6 6 6 6 6 6 6 6 6 6 6 B B B B B B B B B B B B B B B B B B B B A A A A A B B B B B B B B B
3 0 0 0 3 0 0 0 0 0 0 0 0 0 0 3 1 1 0 0 0 0 0 0 0 0 3 0 0 0 0 0 0 4 7 4 4 4 4 4 4 4 4 4 4 4 6 7 6 6 6 6 6 6 4 4 4 4 4 4 7 4 4 6 6 6 B 9 8 8 8 8 8 9 A 8 8 8 8 8 9 9 8 B 8 A 8 9 9 8 8 8 8 8 9 9 9 9 9 9
3 0 0 3 0 1 1 1 1 1 1 0 0 0 3 0 0 0 0 0 0 0 0 0 0 3 0 0 2 2 2 2 2 7 4 4 5 5 5 5 5 5 5 4 4 4 7 4 4 4 4 4 4 4 4 4 4 4 4 7 4 4 4 5 5 5 B 9 8 8 8 8 A 9 9 8 8 8 8 8 9 9 8 B 8 8 8 9 9 8 8 8 8 8 A 9 8 8 8 8
3 0 3 0 0 1 1 1 1 1 1 0 0 3 0 0 0 0 0 0 0 0 0 0 3 0 0 0 0 0 0 0 0 4 4 4 5 5 5 5 5 5 5 4 4 7 4 4 4 4 4 4 4 4 4 4 4 4 7 4 4 4 4 6 6 6 B 9 8 8 A 8 8 9 9 8 8 8 8 9 9 A 8 B 8 8 8 9 9 8 8 8 A 8 9 9 8 9 8 8
3 3 0 0 0 0 0 0 0 0 0 0 3 0 0 0 0 0 0 0 0 0 0 3 0 0 0 0 2 2 2 2 2 4 4 4 4 4 4 4 4 4 4 4 7 4 4 4 4 4 4 4 4 4 4 4 4 7 4 4 4 4 4 5 5 5 B 9 A 8 9 A 8 9 9 8 A 8 8 A 9 A 8 B 8 8 A 9 9 8 A A 8 8 9 9 9 9 9 9
3 0 0 0 0 0 0 0 0 0 0 3 0 0 0 0 0 0 0 0 2 2 2 2 2 0 0 0 0 0 0 0 0 4 4 4 5 5 5 5 5 5 5 7 4 4 4 4 4 4 4 4 4 4 4 4 7 5 5 5 5 5 4 6 6 6 B 9 8 8 8 8 8 9 9 8 8 A 8 8 9 9 8 B 8 8 8 9 A 8 8 8 8 8 9 9 8 8 8 A
3 0 0 0 0 1 1 1 1 1 3 0 0 0 0 0 0 0 0 0 0 3 0 0 0 0 0 0 2 2 2 2 3 4 4 4 5 5 5 5 5 5 7 4 4 4 6 6 6 6 6 6 6 6 4 7 4 4 4 4 4 4 4 5 5 5 B 9 8 8 8 8 8 9 9 A 8 8 8 8 9 9 8 B 8 8 A A A A A 8 8 8 9 9 8 A 8 8
3 0 0 0 0 1 1 1 1 3 1 0 0 0 0 1 1 1 0 0 3 0 0 0 0 0 0 0 0 0 0 3 0 4 4 4 4 4 4 4 4 7 4 4 4 4 6 6 6 6 6 6 6 6 7 4 4 4 4 4 4 4 4 6 6 6 B 9 8 8 9 8 8 A 9 8 8 8 8 9 9 9 8 B A 8 8 9 9 8 8 8 8 8 9 9 9 9 9 9
3 0 0 0 0 0 0 0 3 0 0 0 0 0 0 0 0 0 0 3 0 0 0 0 0 0 0 0 2 2 3 2 2 4 4 4 5 5 5 5 7 5 5 4 4 4 4 4 4 4 4 4 4 7 4 4 4 4 4 4 4 4 4 5 5 5 B 9 8 8 9 A 8 9 9 8 8 8 8 9 9 9 A B 8 8 8 9 9 8 8 8 8 A 9 9 8 9 8 8
3 0 0 0 0 0 0 3 0 0 0 0 0 0 0 0 0 0 3 0 0 0 0 0 0 0 0 0 0 3 0 0 0 4 4 4 5 5 5 7 5 5 5 4 4 4 4 4 4 4 4 4 7 4 4 4 4 4 4 4 4 4 4 6 6 6 B 9 8 A 8 8 8 9 9 8 8 8 8 8 A 9 8 B 8 8 8 9 9 8 8 A 8 8 9 9 8 8 8 8
3 0 0 0 0 1 3 1 1 1 1 0 0 0 0 0 0 3 0 0 2 2 2 2 2 0 0 0 3 2 2 2 2 6 6 6 6 6 6 6 6 6 6 6 6 6 6 6 6 6 6 6 6 6 6 6 6 6 6 6 6 6 6 6 6 6 B A 8 8 8 A 8 9 9 8 A 8 A 8 9 A 8 B 8 8 A 9 9 A 8 A 8 8 9 9 9 9 9 9
3 0 0 0 0 3 1 1 1 1 1 0 0 0 0 0 3 0 0 0 0 0 0 0 0 0 0 3 0 0 0 0 0 4 4 4 5 7 5 5 5 5 5 4 4 4 4 4 4 4 7 4 4 4 4 4 4 4 4 4 4 4 4 6 6 6 B 9 8 8 9 8 8 9 9 8 A 8 8 9 9 9 8 B 8 8 8 A 9 8 8 8 8 8 9 9 8 9 A 8
3 0 0 0 3 0 0 0 0 0 0 0 0 0 0 3 0 0 0 0 0 0 0 0 0 0 3 0 2 2 2 2 2 4 4 4 7 5 5 5 5 5 5 4 4 4 6 6 6 7 6 6 6 6 4 4 4 4 4 4 4 4 7 5 5 5 B 9 8 8 9 8 8 9 A 8 8 8 8 9 9 9 8 B 8 A A A A A A 8 8 8 9 9 A 9 8 8
3 0 0 3 0 0 0 0 0 0 0 0 0 0 3 1 1 1 0 0 0 0 0 0 0 3 0 0 0 0 0 0 0 4 4 7 4 4 4 4 4 4 4 4 4 4 6 6 7 6 6 6 6 6 4 4 4 4 4 4 4 7 4 6 6 6 B 9 8 8 8 8 A 9 9 8 8 8 8 8 9 9 8 B 8 8 8 9 9 8 8 8 8 8 9 9 9 9 9 9
3 0 3 0 0 1 1 1 1 1 1 0 0 3 0 0 0 0 0 0 0 0 0 0 3 0 0 0 2 2 2 2 2 4 7 4 5 5 5 5 5 5 5 4 4 4 4 7 4 4 4 4 4 4 4 4 4 4 4 4 7 4 4 5 5 5 B 9 8 8 A 8 8 9 9 8 8 8 8 8 9 A 8 B 8 8 8 9 9 8 8 8 A 8 9 9 8 8 8 8
3 3 0 0 0 1 1 1 1 1 1 0 3 0 0 0 0 0 0 0 2 2 2 2 2 0 0 0 0 0 0 0 0 7 4 4 5 5 5 5 5 5 5 4 4 4 7 4 4 4 4 4 4 4 4 4 4 5 5 7 5 5 4 6 6 6 B 9 A 8 9 8 8 9 9 8 8 8 8 A 9 9 8 B 8 8 8 9 9 8 A 8 8 8 9 9 8 9 8 8
3 0 0 0 0 0 0 0 0 0 0 3 0 0 0 0 0 0 0 0 0 0 3 0 0 0 0 0 2 2 2 2 2 4 4 4 4 4 4 4 4 4 4 4 4 7 4 4 4 4 4 4 4 4 4 4 4 4 7 4 4 4 4 5 5 5 B 9 8 8 9 A 8 9 9 8 A A 8 9 9 A 8 B 8 8 A 9 A 8 8 A 8 8 9 9 9 9 9 9
3 0 0 0 0 0 0 0 0 0 3 0 0 0 0 0 0 0 0 0 0 3 0 0 0 0 0 0 0 0 0 0 3 4 4 4 5 5 5 5 5 5 5 4 7 4 4 4 4 4 4 4 4 4 4 4 4 7 4 4 4 4 4 6 6 6 B B B B B B B B B B B B B B B B B B B B B B B B B B B B B B B B B B
3 0 0 0 0 1 1 1 1 3 1 0 0 0 0 0 0 0 0 0 3 0 0 0 0 0 0 0 2 2 2 3 2 4 4 4 5 5 5 5 5 5 5 7 4 4 6 6 6 6 6 6 6 6 4 4 7 4 4 4 4 4 4 5 5 5 B 9 8 8 8 8 8 A 9 8 8 8 8 8 9 9 8 B A 8 A A A A A 8 8 8 9 A 8 8 8 8
3 0 0 0 0 1 1 1 3 1 1 0 0 0 0 1 1 1 0 3 0 0 0 0 0 0 0 0 0 0 3 0 0 4 4 4 4 4 4 4 4 4 7 4 4 4 6 6 6 6 6 6 6 6 4 7 4 4 4 4 4 4 4 6 6 6 B 9 8 8 9 A 8 9 9 8 8 8 8 9 9 9 A B 8 8 8 9 9 8 8 8 8 A 9 9 9 9 9 9
3 0 0 0 0 0 0 3 0 0 0 0 0 0 0 0 0 0 3 0 2 2 2 2 2 0 0 0 2 3 2 2 2 6 6 6 6 6 6 6 6 6 6 6 6 6 6 6 6 6 6 6 6 6 6 6 6 6 6 6 6 6 6 6 6 6 B 9 8 A 9 8 8 9 9 8 8 8 8 9 A 9 8 B 8 8 8 9 9 8 8 A 8 8 9 9 8 9 8 8
3 0 0 0 0 0 3 0 0 0 0 0 0 0 0 0 0 3 0 0 0 0 0 0 0 0 0 0 3 0 0 0 0 4 4 4 5 5 5 5 7 5 5 4 4 4 4 4 4 4 4 4 4 7 4 4 4 4 4 4 4 4 4 6 6 6 B A 8 8 8 8 8 9 9 8 8 8 A 8 9 9 8 B 8 8 8 9 9 A 8 8 8 8 9 9 8 8 8 8
3 0 0 0 0 3 1 1 1 1 1 0 0 0 0 0 3 0 0 0 0 0 0 0 0 0 0 3 2 2 2 2 2 4 4 4 4 4 4 7 4 4 4 4 4 4 4 4 4 4 4 4 7 4 4 4 4 4 4 4 4 4 4 5 5 5 B 9 8 8 8 A 8 9 9 8 A 8 8 8 9 A 8 B 8 8 A A 9 8 8 A 8 8 9 9 9 9 9 9
3 0 0 0 3 1 1 1 1 1 1 0 0 0 0 3 0 0 0 0 0 0 0 0 0 0 3 0 0 0 0 0 0 4 4 4 5 5 7 5 5 5 5 4 4 4 4 4 4 4 4 7 4 4 4 4 4 4 4 4 4 4 4 6 6 6 B 9 8 8 9 8 8 9 A 8 8 8 8 9 9 9 8 B 8 A 8 9 9 8 8 8 8 8 9 9 A 9 8 8
3 0 0 3 0 0 0 0 0 0 0 0 0 0 3 0 0 0 0 0 0 0 0 0 0 3 0 0 2 2 2 2 2 4 4 4 5 7 5 5 5 5 5 4 4 4 6 6 6 6 7 6 6 6 4 4 4 4 4 4 4 4 4 5 5 5 B 9 8 8 9 8 A 9 9 8 8 8 8 9 9 9 8 B 8 8 A A A A A 8 8 8 A 9 8 9 8 8
3 0 3 0 0 0 0 0 0 0 0 0 0 3 0 1 1 1 0 0 2 2 2 2 2 0 0 0 0 0 0 0 0 4 4 4 7 4 4 4 4 4 4 4 4 4 6 6 6 7 6 6 6 6 4 4 4 5 5 5 5 5 7 6 6 6 B 9 8 8 A 8 8 9 9 8 8 8 8 8 9 A 8 B 8 8 8 9 9 8 8 8 A 8 9 9 9 9 9 9
3 3 0 0 0 1 1 1 1 1 1 0 3 0 0 0 0 0 0 0 0 0 0 3 0 0 0 0 2 2 2 2 2 4 4 7 5 5 5 5 5 5 5 4 4 4 4 4 7 4 4 4 4 4 4 4 4 4 4 4 4 7 4 5 5 5 B 9 A 8 8 8 8 9 9 8 8 8 8 A 9 9 8 B 8 8 8 9 9 8 A 8 8 8 9 9 8 8 8 8
3 0 0 0 0 1 1 1 1 1 1 3 0 0 0 0 0 0 0 0 0 0 3 0 0 0 0 0 0 0 0 0 0 4 7 4 5 5 5 5 5 5 5 4 4 4 4 7 4 4 4 4 4 4 4 4 4 4 4 4 7 4 4 6 6 6 B 9 8 8 9 8 8 9 9 8 8 A 8 9 9 9 8 B 8 8 8 9 A 8 8 8 8 8 9 9 8 9 8 A
3 0 0 0 0 0 0 0 0 0 3 0 0 0 0 0 0 0 0 0 0 3 0 0 0 0 0 0 2 2 2 2 3 7 4 4 4 4 4 4 4 4 4 4 4 4 7 4 4 4 4 4 4 4 4 4 4 4 4 7 4 4 4 5 5 5 B 9 8 8 9 A 8 9 9 A A 8 8 9 9 A 8 B 8 8 A 9 9 8 8 A 8 8 9 9 9 9 9 9
3 0 0 0 0 0 0 0 0 3 0 0 0 0 0 0 0 0 0 0 3 0 0 0 0 0 0 0 0 0 0 3 0 4 4 4 5 5 5 5 5 5 5 4 4 7 4 4 4 4 4 4 4 4 4 4 4 4 7 4 4 4 4 6 6 6 B 9 8 8 8 8 8 A 9 8 8 8 8 8 9 9 8 B A 8 8 9 9 8 8 8 8 8 9 A 8 8 8 8
3 0 0 0 0 1 1 1 3 1 1 0 0 0 0 0 0 0 0 3 2 2 2 2 2 0 0 0 2 2 3 2 2 6 6 6 6 6 6 6 6 6 6 6 6 6 6 6 6 6 6 6 6 6 6 6 6 6 6 6 6 6 6 6 6 6 B 9 8 8 8 A 8 9 9 8 8 8 8 8 9 9 A B 8 8 A A A A A 8 8 A 9 9 8 8 8 8
3 0 0 0 0 1 1 3 1 1 1 0 0 0 0 1 1 1 3 0 0 0 0 0 0 0 0 0 0 3 0 0 0 4 4 4 4 4 4 4 4 4 4 7 4 4 6 6 6 6 6 6 6 6 4 4 7 4 4 4 4 4 4 6 6 6 B 9 8 A 9 8 8 9 9 8 8 8 8 9 A 9 8 B 8 8 8 9 9 8 8 A 8 8 9 9 9 9 9 9
3 0 0 0 0 0 3 0 0 0 0 0 0 0 0 0 0 3 0 0 0 0 0 0 0 0 0 0 3 2 2 2 2 4 4 4 5 5 5 5 5 5 7 4 4 4 4 4 4 4 4 4 4 4 4 7 4 4 4 4 4 4 4 5 5 5 B A 8 8 9 8 8 9 9 8 8 8 A 9 9 9 8 B 8 8 8 9 9 A 8 8 8 8 9 9 8 9 8 8
3 0 0 0 0 3 0 0 0 0 0 0 0 0 0 0 3 0 0 0 0 0 0 0 0 0 0 3 0 0 0 0 0 4 4 4 5 5 5 5 5 7 5 4 4 4 4 4 4 4 4 4 4 4 7 4 4 4 4 4 4 4 4 6 6 6 B 9 8 8 8 8 8 9 9 8 A 8 8 8 9 9 8 B 8 8 8 A 9 8 8 8 8 8 9 9 8 8 A 8
3 0 0 0 3 1 1 1 1 1 1 0 0 0 0 3 0 0 0 0 0 0 0 0 0 0 3 0 2 2 2 2 2 4 4 4 4 4 4 4 7 4 4 4 4 4 4 4 4 4 4 4 4 7 4 4 4 4 4 4 4 4 4 5 5 5 B B B B B B B B B B B B B B B B B B B B B B B B B B B B 9 9 9 9 9 9
3 0 0 3 0 1 1 1 1 1 1 0 0 0 3 0 0 0 0 0 2 2 2 2 2 3 0 0 0 0 0 0 0 4 4 4 5 5 5 7 5 5 5 4 4 4 4 4 4 4 4 4 7 4 4 4 4 5 5 5 5 5 4 6 6 6 B 9 8 8 9 8 A 9 9 8 8 8 8 9 9 9 8 B 8 8 8 9 9 8 8 8 8 8 A 9 8 9 8 8
3 0 3 0 0 0 0 0 0 0 0 0 0 3 0 0 0 0 0 0 0 0 0 0 3 0 0 0 2 2 2 2 2 4 4 4 5 5 7 5 5 5 5 4 4 4 6 6 6 6 6 7 6 6 4 4 4 4 4 4 4 4 4 5 5 5 B 9 8 8 A 8 8 9 9 8 8 8 8 9 9 A 8 B 8 8 A A A A A 8 A 8 9 9 8 9 8 8
3 3 0 0 0 0 0 0 0 0 0 0 3 0 0 1 1 1 0 0 0 0 0 3 0 0 0 0 0 0 0 0 0 4 4 4 4 7 4 4 4 4 4 4 4 4 6 6 6 6 7 6 6 6 4 4 4 4 4 4 4 4 4 6 6 6 B 9 A 8 8 8 8 9 9 8 8 8 8 A 9 9 8 B 8 8 8 9 9 8 A 8 8 8 9 9 9 9 9 9
3 0 0 0 0 1 1 1 1 1 1 3 0 0 0 0 0 0 0 0 0 0 3 0 0 0 0 0 2 2 2 2 2 4 4 4 7 5 5 5 5 5 5 4 4 4 4 4 4 7 4 4 4 4 4 4 4 4 4 4 4 4 7 5 5 5 B 9 8 8 8 8 8 9 9 8 8 A 8 8 9 9 8 B 8 8 8 9 A 8 8 8 8 8 9 9 8 8 8 A
3 0 0 0 0 1 1 1 1 1 3 0 0 0 0 0 0 0 0 0 0 3 0 0 0 0 0 0 0 0 0 0 3 4 4 7 5 5 5 5 5 5 5 4 4 4 4 4 7 4 4 4 4 4 4 4 4 4 4 4 4 7 4 6 6 6 B 9 8 8 9 8 8 9 9 A 8 8 8 9 9 9 8 B 8 8 A 9 9 8 8 8 8 8 9 9 8 A 8 8
3 0 0 0 0 0 0 0 0 3 0 0 0 0 0 0 0 0 0 0 2 2 2 2 2 0 0 0 2 2 2 3 2 6 6 6 6 6 6 6 6 6 6 6 6 6 6 6 6 6 6 6 6 6 6 6 6 6 6 6 6 6 6 6 6 6 B 9 8 8 9 A 8 A 9 8 A 8 8 9 9 A 8 B A 8 A 9 9 8 8 A 8 8 9 9 9 9 9 9
3 0 0 0 0 0 0 0 3 0 0 0 0 0 0 0 0 0 0 3 0 0 0 0 0 0 0 0 0 0 3 0 0 7 4 4 5 5 5 5 5 5 5 4 4 4 7 4 4 4 4 4 4 4 4 4 4 4 4 7 4 4 4 6 6 6 B 9 8 8 8 A 8 9 9 8 8 8 8 8 9 9 A B 8 8 8 9 9 8 8 8 8 A 9 9 8 8 8 8
3 0 0 0 0 1 1 3 1 1 1 0 0 0 0 0 0 0 3 0 0 0 0 0 0 0 0 0 2 3 2 2 2 4 4 4 5 5 5 5 5 5 5 4 4 7 6 6 6 6 6 6 6 6 4 4 4 4 7 4 4 4 4 5 5 5 B 9 8 A 8 8 8 9 9 8 8 8 8 8 A 9 8 B 8 8 A A A A A A 8 8 9 9 8 8 8 8
3 0 0 0 0 1 3 1 1 1 1 0 0 0 0 1 1 3 0 0 0 0 0 0 0 0 0 0 3 0 0 0 0 4 4 4 4 4 4 4 4 4 4 4 7 4 6 6 6 6 6 6 6 6 4 4 4 7 4 4 4 4 4 6 6 6 B A 8 8 9 8 8 9 9 8 8 8 A 9 9 9 8 B 8 8 8 9 9 A 8 8 8 8 9 9 9 9 9 9
3 0 0 0 0 3 0 0 0 0 0 0 0 0 0 0 3 0 0 0 0 0 0 0 0 0 0 3 2 2 2 2 2 4 4 4 5 5 5 5 5 5 5 7 4 4 4 4 4 4 4 4 4 4 4 4 7 4 4 4 4 4 4 5 5 5 B 9 8 8 9 8 8 9 9 8 A 8 8 9 9 9 8 B 8 8 8 A 9 8 8 8 8 8 9 9 8 9 A 8
3 0 0 0 3 0 0 0 0 0 0 0 0 0 0 3 0 0 0 0 2 2 2 2 2 0 3 0 0 0 0 0 0 4 4 4 5 5 5 5 5 5 7 4 4 4 4 4 4 4 4 4 4 4 4 7 4 5 5 5 5 5 4 6 6 6 B 9 8 8 8 8 8 9 A 8 8 8 8 8 9 9 8 B 8 A 8 9 9 8 8 8 8 8 9 9 A 8 8 8
3 0 0 3 0 1 1 1 1 1 1 0 0 0 3 0 0 0 0 0 0 0 0 0 0 3 0 0 2 2 2 2 2 4 4 4 4 4 4 4 4 7 4 4 4 4 4 4 4 4 4 4 4 4 7 4 4 4 4 4 4 4 4 5 5 5 B 9 8 8 8 A A 9 9 8 A 8 8 8 9 A 8 B 8 8 A 9 9 8 8 A 8 8 9 9 9 9 9 9
3 0 3 0 0 1 1 1 1 1 1 0 0 3 0 0 0 0 0 0 0 0 0 0 3 0 0 0 0 0 0 0 0 4 4 4 5 5 5 5 7 5 5 4 4 4 4 4 4 4 4 4 4 7 4 4 4 4 4 4 4 4 4 6 6 6 B 9 8 8 A 8 8 9 9 8 8 8 8 9 9 A 8 B 8 8 8 9 9 8 8 8 A 8 9 9 8 9 8 8
3 3 0 0 0 0 0 0 0 0 0 0 3 0 0 0 0 0 0 0 0 0 0 3 0 0 0 0 2 2 2 2 2 4 4 4 5 5 5 7 5 5 5 4 4 4 6 6 6 6 6 6 7 6 4 4 4 4 4 4 4 4 4 5 5 5 B 9 A 8 9 8 8 9 9 8 8 8 8 A 9 9 8 B 8 8 A A A A A 8 8 8 9 9 8 9 8 8
3 3 3 3 3 3 3 3 3 3 3 3 3 3 3 3 3 3 3 3 3 3 3 3 3 3 3 3 3 3 3 3 3 4 4 4 4 4 7 4 4 4 4 4 4 4 6 6 6 6 6 7 6 6 4 4 4 4 4 4 4 4 4 6 6 6 B 9 8 8 8 8 8 9 9 8 8 A 8 8 9 9 8 B 8 8 8 9 A 8 8 8 8 8 9 9 9 9 9 9
R 20 80 1 1
R 26 35 1 1
R 28 55 1 1
R 40 25 2 1
R 42 65 2 1
R 52 30 2 1
R 59 80 2 1
R 60 50 2 1
R 73 20 3 1
R 78 45 3 1
R 82 70 3 1
R 89 35 3 1
R 92 85 3 1
