100 100
0 0 0 0 0 2 2 2 2 2 2 2 2 2 2 2 2 2 2 2 2 2 2 2 2 2 2 2 2 2 2 2 2 2 2 2 2 2 2 2 2 2 2 0 2 2 2 2 2 2 5 5 5 5 5 5 5 5 5 5 4 4 4 4 4 4 4 4 4 4 4 4 4 4 4 4 4 4 4 4 4 4 4 4 4 4 4 4 4 4 4 4 4 4 4 4 4 4 4 4
0 0 0 0 0 0 0 0 0 0 1 1 0 0 0 0 0 0 0 0 1 1 0 0 0 0 0 0 0 0 0 0 0 0 0 1 1 0 0 0 0 0 0 0 2 2 2 2 2 2 4 4 4 4 4 4 4 4 4 4 4 4 4 4 4 4 4 4 4 4 4 4 4 4 4 4 4 4 4 4 4 4 4 4 4 4 4 4 4 4 4 4 4 4 4 4 4 4 4 4
0 0 0 0 0 0 0 0 0 0 0 0 0 0 0 0 0 0 0 0 0 0 0 0 0 0 0 0 0 0 0 0 0 0 0 0 0 0 0 0 0 0 0 0 2 2 2 2 2 2 4 4 4 4 4 4 4 4 4 4 4 4 4 4 4 4 4 4 4 4 4 4 4 4 4 4 4 4 4 4 4 4 4 4 4 4 4 4 4 4 4 4 4 4 4 4 4 4 4 4
0 0 0 0 0 0 0 0 0 0 0 0 0 0 0 0 0 0 0 0 0 0 0 0 0 0 0 0 0 0 0 0 0 0 0 0 0 0 0 0 0 0 0 0 2 2 2 2 2 2 4 4 4 4 4 4 4 4 4 4 4 4 4 4 4 4 4 4 4 4 4 4 4 4 4 4 4 4 4 4 4 4 4 4 4 4 4 4 4 4 4 4 4 4 4 4 4 4 4 4
0 0 0 0 0 0 0 0 0 0 0 0 0 0 0 0 0 0 0 0 0 0 0 0 0 0 0 0 0 0 0 0 0 0 0 0 0 0 0 0 0 0 0 0 2 2 2 2 2 2 4 4 4 4 4 4 4 4 4 4 5 4 4 4 4 4 4 4 4 4 4 4 4 4 4 4 4 4 4 4 4 4 4 4 4 4 4 4 4 4 4 4 4 4 4 4 4 4 4 4
0 0 0 0 2 0 0 2 0 0 1 1 0 2 0 0 2 0 0 2 1 1 2 0 0 2 0 0 2 0 0 2 0 0 2 1 1 2 0 0 2 0 0 2 2 2 2 2 2 2 4 4 4 4 4 7 4 5 5 5 6 5 5 5 4 4 4 7 4 4 4 4 4 4 4 4 4 4 4 7 4 4 4 4 4 4 4 4 4 4 4 7 4 4 4 4 4 4 4 4
0 0 0 0 2 0 0 2 0 0 1 1 0 2 0 0 2 0 0 2 1 1 2 0 0 2 0 0 2 0 3 2 0 0 2 1 1 2 0 0 2 0 0 2 2 2 2 2 2 2 5 5 5 5 5 5 5 5 5 5 6 6 6 6 5 4 4 4 4 4 4 4 4 4 4 4 4 4 4 4 4 4 4 4 4 4 4 4 4 4 4 4 4 4 4 4 4 4 4 4
0 0 0 0 0 2 2 2 2 2 2 2 2 2 2 2 2 2 2 2 2 2 2 2 2 2 2 2 2 3 3 3 2 2 2 2 2 2 2 2 2 2 2 0 2 2 2 2 2 2 4 4 4 4 4 5 6 6 6 6 6 6 6 6 6 5 4 4 4 4 4 4 4 4 4 4 4 4 4 4 4 4 4 4 4 4 4 4 4 4 4 4 4 4 4 4 4 4 4 4
0 0 0 0 0 0 0 0 0 0 0 0 0 0 0 0 0 0 0 0 0 0 0 0 0 0 0 0 3 3 3 3 3 0 0 0 0 0 0 0 0 0 0 0 2 2 2 2 2 2 4 4 4 4 4 5 6 6 6 6 6 6 6 6 6 5 4 4 4 4 4 4 4 4 4 4 4 4 4 4 4 4 4 4 4 4 4 4 4 4 4 4 4 4 4 4 4 4 4 4
0 0 0 0 0 0 0 0 0 0 0 0 0 0 0 0 0 0 0 0 0 0 0 0 0 0 0 0 0 3 3 3 0 0 0 0 0 0 0 0 0 0 0 0 2 2 2 2 2 2 4 4 4 4 4 5 6 6 6 6 6 6 6 6 6 5 4 4 4 4 4 4 4 4 4 4 4 4 4 4 4 4 4 4 4 4 4 4 4 4 4 4 4 4 4 4 4 4 4 4
0 0 0 0 0 0 0 0 0 0 1 1 3 0 0 0 0 0 0 0 1 1 0 0 0 0 0 0 0 0 3 0 0 0 0 1 1 0 0 0 0 0 0 0 2 2 2 2 2 2 4 4 4 4 5 6 6 6 6 6 6 6 6 6 6 6 5 4 4 4 4 4 4 4 4 4 4 4 4 4 4 4 4 4 4 4 4 4 4 4 4 4 4 4 4 4 4 4 4 4
0 0 0 0 0 0 0 0 0 0 1 3 3 3 0 0 0 0 0 0 2 1 0 0 0 0 0 0 0 0 0 0 0 0 0 1 1 0 0 0 0 0 0 0 2 2 2 2 2 2 4 4 4 4 4 5 6 6 6 6 6 6 6 6 6 5 4 4 4 4 4 4 4 4 4 4 4 4 4 4 4 4 4 4 4 4 4 4 4 4 4 4 4 4 4 4 4 4 4 4
0 0 0 0 0 0 0 0 0 0 3 3 3 3 3 0 0 0 0 0 0 0 0 0 0 0 0 0 0 0 0 0 0 0 0 0 0 0 0 0 0 0 0 0 2 2 2 2 2 2 5 5 5 5 5 5 5 5 5 5 4 6 6 6 6 5 4 4 4 4 4 4 4 4 4 4 4 4 4 4 4 4 4 4 4 4 4 4 4 4 4 4 4 4 4 4 4 4 4 4
0 0 2 0 0 2 0 0 2 0 0 3 3 3 2 0 0 2 0 0 2 0 0 2 0 0 2 0 0 2 0 0 2 0 0 2 0 0 2 0 0 2 0 0 2 2 2 2 2 2 4 4 4 4 4 5 6 6 6 6 6 6 6 6 6 5 4 4 4 4 4 4 4 4 4 4 4 4 4 4 5 4 4 4 4 4 4 4 4 4 4 4 4 4 4 4 4 4 4 4
0 0 2 0 0 2 2 2 2 2 2 2 3 2 2 2 2 2 2 2 2 2 2 2 2 2 2 2 2 2 2 2 2 2 2 2 2 2 2 2 2 2 2 0 2 2 2 2 2 2 4 4 4 4 4 4 5 6 6 6 6 6 6 6 5 4 4 4 4 4 4 4 4 4 4 4 4 5 5 5 6 5 5 5 4 4 4 4 4 4 4 4 4 4 4 4 4 4 4 4
0 0 0 0 0 0 0 0 0 0 1 1 0 0 0 0 0 0 0 0 1 1 0 0 0 0 0 0 0 0 0 0 0 0 0 1 1 0 0 0 0 0 0 0 2 2 2 2 2 2 4 4 4 4 4 4 4 5 5 5 6 5 5 5 4 4 4 4 4 4 4 4 4 4 4 4 5 5 6 6 6 6 6 5 5 4 4 4 4 4 4 4 4 4 4 4 4 4 4 4
0 0 0 0 0 0 0 0 0 0 1 1 0 0 0 0 0 0 0 0 1 1 0 0 0 0 0 0 0 0 0 0 0 0 0 1 1 0 0 0 3 0 0 0 2 2 2 2 2 2 4 4 4 4 4 4 4 4 4 4 5 4 4 4 4 4 4 4 4 4 4 4 4 4 4 4 5 6 6 6 6 6 6 6 5 4 4 4 4 4 4 4 4 4 4 4 4 4 4 4
0 0 0 0 0 0 0 0 0 0 0 0 0 0 0 0 0 0 0 0 0 0 0 0 0 0 0 0 0 0 0 0 0 0 0 0 0 0 0 3 3 3 0 0 2 2 2 2 2 2 4 4 4 4 4 4 4 4 4 4 4 4 4 4 4 4 4 4 4 4 4 4 4 4 4 4 5 6 6 6 6 6 6 6 5 4 4 4 4 4 4 4 4 4 4 4 4 4 4 4
0 0 0 0 0 0 0 0 0 0 0 0 0 0 0 0 0 0 0 0 0 0 0 0 0 0 0 0 0 0 0 0 0 0 0 0 0 0 3 3 3 3 3 0 2 2 2 2 2 2 5 5 5 5 5 5 5 5 5 5 4 4 4 4 4 4 4 4 4 4 4 4 4 4 4 5 6 6 6 6 6 6 6 6 6 5 4 4 4 4 4 4 4 4 4 4 4 4 4 4
0 0 0 0 0 0 0 0 0 0 0 0 0 0 0 0 0 0 0 0 0 0 0 0 0 0 0 0 0 0 0 0 0 0 0 0 0 0 0 3 3 3 0 0 2 2 2 2 2 2 4 4 4 4 4 4 4 4 4 4 4 7 4 4 4 4 4 4 4 4 4 4 4 7 4 4 5 6 6 6 6 6 6 6 5 7 4 4 4 4 4 4 4 4 4 4 4 7 4 4
0 0 0 0 0 0 0 0 0 0 1 2 0 0 0 0 0 0 0 0 1 1 0 0 0 0 0 0 0 0 0 0 0 0 0 1 1 0 0 0 3 0 0 0 2 2 2 2 2 2 4 4 4 4 4 4 4 4 4 4 4 4 4 4 4 4 4 4 4 4 4 4 4 4 4 4 4 4 4 4 4 4 4 4 4 4 4 4 4 4 4 4 4 4 4 4 4 4 4 4
0 0 0 2 0 2 2 2 2 2 2 2 2 2 2 2 2 2 2 2 2 2 2 2 2 2 2 2 2 2 2 2 2 2 2 2 2 2 2 2 2 2 2 0 2 2 2 2 2 2 4 4 4 4 4 4 4 4 4 4 4 4 4 4 4 4 4 4 4 4 4 4 4 4 4 4 5 5 6 6 6 6 6 5 5 4 4 4 4 4 4 4 4 4 4 4 4 4 4 4
0 0 0 2 0 0 2 0 0 2 0 0 2 0 0 2 0 0 2 0 0 2 0 0 2 0 0 2 0 0 2 0 0 2 0 0 2 0 0 2 0 0 2 0 2 2 2 2 2 2 4 4 4 4 4 4 4 4 4 4 4 4 4 4 4 4 4 4 4 4 4 4 4 4 4 4 4 5 5 5 6 5 5 5 4 4 4 4 4 4 4 4 4 4 4 4 4 4 4 4
0 0 0 0 0 0 0 0 0 0 0 0 0 0 0 0 0 0 0 0 0 0 3 0 0 0 0 0 0 0 0 0 0 0 0 0 0 0 0 0 0 0 0 0 2 2 2 2 2 2 4 4 4 4 4 4 4 4 4 4 4 4 4 4 4 4 4 4 4 4 4 4 4 4 4 4 4 4 4 4 5 4 4 4 4 4 4 4 4 4 4 4 4 4 4 4 4 4 4 4
0 0 0 0 0 0 0 0 0 0 0 0 0 0 0 0 0 0 0 0 0 3 3 3 0 0 0 0 0 0 0 0 0 0 0 0 0 0 0 0 0 0 0 0 2 2 2 2 2 2 5 5 5 5 5 5 5 5 5 5 4 4 4 4 4 4 4 4 4 4 4 4 4 4 4 4 4 4 4 4 4 4 4 4 4 4 4 4 4 4 4 4 4 4 4 4 4 4 4 4
0 0 0 0 0 0 0 0 0 0 1 1 0 0 0 0 0 0 0 0 3 3 3 3 3 0 0 0 0 0 0 0 0 0 0 1 1 0 0 0 2 0 0 0 2 2 2 2 2 2 4 4 4 4 4 4 4 4 4 4 4 4 4 4 4 4 4 4 4 4 4 4 4 4 4 4 4 4 4 4 4 4 4 4 4 4 4 4 4 4 4 4 4 4 4 4 4 4 4 4
0 0 0 0 0 0 0 0 0 0 1 1 0 0 0 0 0 0 0 0 1 3 3 3 0 0 0 0 0 0 0 0 0 0 0 2 1 0 0 0 0 0 0 0 2 2 2 2 2 2 4 4 4 4 4 4 4 4 4 4 4 4 4 4 4 5 4 4 4 4 4 4 4 4 4 4 4 4 4 4 4 4 4 4 4 4 4 4 4 4 4 4 4 4 4 4 4 4 4 4
0 0 0 0 0 0 0 0 0 0 0 0 0 0 0 0 0 0 0 0 0 0 3 0 0 0 0 0 0 0 0 0 0 0 0 0 0 0 0 0 0 0 0 0 2 2 2 2 2 2 4 4 4 4 4 4 4 4 4 4 4 4 4 5 5 6 5 5 4 4 4 4 4 4 4 4 4 4 4 4 4 4 4 4 4 4 4 4 4 4 4 4 4 4 4 4 4 4 4 4
0 0 0 0 0 2 2 2 2 2 2 2 2 2 2 2 2 2 2 2 2 2 2 2 2 2 2 2 2 2 2 2 2 2 2 2 2 2 2 2 2 2 2 0 2 2 2 2 2 2 4 4 4 4 4 4 4 4 4 4 4 4 5 6 6 6 6 6 5 4 4 4 4 4 4 4 4 4 4 4 4 4 4 4 4 4 4 4 4 4 4 4 4 4 4 4 4 4 4 4
0 0 0 0 2 0 0 2 0 0 2 0 0 2 0 0 2 0 0 2 0 0 2 0 0 2 0 0 2 0 0 2 0 0 2 0 0 2 0 0 2 0 0 2 2 2 2 2 2 2 4 4 4 4 4 4 4 4 4 4 4 4 5 6 6 6 6 6 5 4 4 4 4 4 4 4 4 4 4 4 4 4 4 4 4 4 4 4 4 4 4 4 4 4 4 4 4 4 4 4
0 0 0 0 2 0 0 2 0 0 1 1 0 2 0 0 2 0 0 2 1 1 2 0 0 2 0 0 2 0 0 2 0 0 2 1 1 2 0 0 2 0 0 2 2 2 2 2 2 2 5 5 4 5 5 5 5 5 5 5 4 5 6 6 6 6 6 6 6 5 4 4 4 4 4 4 4 4 4 4 4 4 4 4 4 4 4 4 4 4 4 4 4 4 4 4 4 4 4 4
0 0 0 0 0 0 0 0 0 0 1 1 0 0 0 0 0 0 0 0 1 1 0 0 0 0 0 0 0 0 0 0 0 0 0 1 1 0 0 0 0 0 0 0 2 2 2 2 2 2 4 4 4 4 4 4 4 4 4 4 4 4 5 6 6 6 6 6 5 4 4 4 4 4 4 4 4 4 4 4 4 4 4 4 4 4 4 4 4 4 4 4 4 4 4 4 4 4 4 4
0 0 0 0 0 0 0 0 0 0 0 0 0 0 0 0 0 0 0 0 0 0 0 0 0 0 0 0 0 0 0 0 0 0 0 0 0 0 0 0 0 0 0 0 2 2 2 2 2 2 4 4 4 4 4 4 4 4 4 4 4 4 4 4 4 4 4 4 4 4 4 4 4 4 4 4 4 4 4 4 4 4 4 4 4 4 4 4 4 4 4 4 4 4 4 4 4 4 4 4
0 0 0 0 0 0 0 0 0 0 0 0 0 0 0 0 0 0 0 0 0 0 0 0 0 0 0 0 0 0 0 0 0 0 0 0 0 0 0 0 0 0 0 0 2 2 2 2 2 2 4 4 4 4 4 7 4 4 4 4 4 4 4 5 5 6 5 7 4 4 4 4 4 4 4 4 4 4 4 7 4 4 4 4 4 4 4 4 4 4 4 7 4 4 4 4 4 4 4 4
0 0 0 0 0 0 0 0 0 0 0 0 0 0 0 0 0 0 0 0 0 0 0 0 0 0 0 0 0 0 0 0 0 0 0 0 0 0 0 0 0 0 0 0 2 2 2 2 2 2 4 4 4 4 4 4 4 4 4 4 4 4 4 4 4 5 4 4 4 4 4 4 4 4 4 4 4 4 4 4 4 4 4 4 4 4 4 4 4 4 4 4 4 4 4 4 4 4 4 4
0 0 0 0 0 2 2 2 2 2 2 2 2 2 2 2 2 2 2 2 2 2 2 2 2 2 2 2 2 2 2 2 2 2 2 2 2 2 2 2 2 2 2 0 2 2 2 2 2 2 4 4 4 4 4 4 4 4 4 4 4 4 4 4 4 4 4 4 4 4 4 4 4 4 4 4 4 4 4 4 4 4 4 4 4 4 4 4 4 4 4 4 4 4 4 4 4 4 4 4
0 0 0 0 0 0 0 0 0 0 1 1 0 0 0 0 0 0 0 0 1 1 0 0 0 0 0 0 0 0 0 0 0 0 0 1 1 0 0 0 0 0 0 0 2 2 2 2 2 2 5 5 5 5 5 5 5 5 5 5 4 4 4 4 4 4 4 4 4 4 4 4 4 4 4 4 4 4 4 4 4 4 4 4 4 4 4 4 4 4 4 4 4 4 4 4 4 4 4 4
0 0 2 0 0 2 0 0 2 0 0 2 0 0 2 0 0 2 0 0 2 0 0 2 0 0 2 0 0 2 0 0 2 0 0 2 0 0 2 0 0 2 0 0 2 2 2 2 2 2 4 4 4 4 4 4 4 4 4 4 4 4 4 4 4 4 4 4 4 4 4 4 4 4 4 4 4 4 4 4 4 4 4 4 4 4 4 4 4 4 4 4 4 4 4 4 4 4 4 4
0 0 2 0 0 2 0 0 2 0 0 2 0 0 2 0 0 2 0 0 2 0 0 2 0 0 2 0 0 2 0 0 2 0 0 2 0 0 2 0 0 2 0 0 2 2 2 2 2 2 4 4 4 4 4 4 4 4 4 4 4 4 4 4 4 4 4 4 4 4 4 4 4 4 4 4 4 4 4 4 4 4 4 4 4 4 4 4 4 4 4 4 4 4 4 4 4 4 4 4
0 0 0 0 0 0 0 0 0 0 0 0 0 0 0 0 0 0 0 0 0 0 0 0 0 0 0 0 0 0 0 0 0 0 0 0 0 0 0 0 0 0 0 0 2 2 2 2 2 2 4 4 4 4 4 4 4 4 4 4 4 4 4 4 4 4 4 4 4 4 4 4 4 4 4 4 4 4 4 4 4 4 4 4 4 4 4 4 4 4 4 4 4 4 4 4 4 4 4 4
0 0 0 0 0 0 0 0 0 0 1 1 0 0 0 0 0 0 0 0 1 1 0 0 0 2 0 0 0 0 0 0 0 0 0 1 1 0 0 0 0 0 0 0 2 2 2 2 2 2 4 4 4 4 4 4 4 4 4 4 4 4 4 4 4 4 4 4 4 4 4 4 4 4 4 4 4 4 4 4 4 4 4 4 4 4 4 4 4 4 4 4 4 4 4 4 4 4 4 4
0 0 0 0 0 0 0 0 0 0 1 1 0 0 0 0 0 0 0 0 1 1 0 0 0 0 0 0 0 0 0 0 0 0 0 1 1 0 0 0 0 0 0 0 2 2 2 2 2 2 4 4 4 4 4 4 4 4 4 4 4 4 4 4 4 4 4 4 4 4 4 4 4 4 4 4 4 4 4 4 4 4 4 4 4 4 4 4 4 4 4 4 4 4 4 4 4 4 4 4
0 0 0 0 0 2 2 2 2 2 2 2 2 2 2 2 2 2 2 2 2 2 2 2 2 2 2 2 2 2 2 2 2 2 2 2 2 2 2 2 2 2 2 0 2 2 2 2 2 2 5 5 5 5 5 5 5 5 5 5 4 4 4 4 4 4 4 4 4 4 4 4 4 4 4 4 4 4 4 4 4 4 4 4 4 4 4 4 4 4 4 4 4 4 4 4 4 4 4 4
0 0 0 0 0 0 0 0 0 0 0 0 0 0 0 0 0 0 0 0 0 0 0 0 0 0 0 0 0 0 0 0 0 0 0 0 0 0 0 0 0 0 0 0 2 2 2 2 2 2 4 4 4 4 4 4 4 4 4 4 4 4 4 4 4 4 4 4 4 4 4 4 4 4 4 4 4 4 4 4 4 4 4 4 4 4 4 4 4 4 4 4 4 4 4 4 4 4 4 4
0 0 0 0 0 0 0 0 0 0 0 0 0 0 0 0 0 0 0 0 0 0 0 0 0 0 0 0 0 0 0 0 0 0 0 0 0 0 0 0 0 0 0 0 2 2 2 2 2 2 4 4 4 4 4 4 4 4 4 4 4 4 4 4 4 4 4 4 4 4 4 4 4 4 4 4 4 4 4 4 4 4 4 4 4 4 4 4 4 4 4 4 4 4 4 4 4 4 4 4
2 2 2 2 2 2 2 2 2 2 2 2 2 2 2 2 2 2 2 2 2 2 2 2 2 2 2 2 2 2 2 2 2 2 2 2 2 2 2 2 2 2 2 2 2 2 2 2 A A C 4 4 4 4 4 4 4 4 4 4 4 4 4 4 4 4 4 4 4 4 4 4 4 4 4 4 4 4 4 4 4 4 4 4 4 4 4 4 4 4 4 4 4 4 4 4 4 4 4
2 2 2 2 2 2 2 2 2 2 2 2 2 2 2 2 2 2 2 2 2 2 2 2 2 2 2 2 2 2 2 2 2 2 2 2 2 2 2 2 2 2 2 2 2 2 2 2 A A C 4 4 4 4 4 4 4 4 4 4 4 4 4 4 4 4 4 4 4 4 4 4 4 4 4 4 4 4 4 4 4 4 4 4 4 4 4 4 4 4 4 4 4 4 4 4 4 4 4
8 8 8 8 8 8 8 8 8 8 8 8 8 8 8 8 8 8 9 9 8 8 A 8 8 8 8 8 8 8 8 8 8 8 8 A 8 8 9 9 8 8 8 8 8 8 8 8 A A C C C C C C C C C C C C C C C C C C C C C C C C C C C C C C C C C C C C C C C C C C C C C C C C C C
8 8 8 8 8 8 8 8 9 9 8 8 8 8 8 8 8 8 8 8 8 8 A 8 8 8 8 8 9 9 8 8 8 8 8 A 8 8 8 8 8 8 8 8 8 8 8 8 A A C C C C C C C C C C C C C C C C C C C C C C C C C C C C C C C C C C C C C C C C C C C C C C C C C C
8 8 8 8 8 8 8 8 9 9 8 8 8 8 8 8 8 8 8 8 8 8 A 8 8 8 8 8 9 9 8 8 8 8 8 A 8 8 8 8 8 8 8 8 8 8 8 8 A A C C C C C C C C C C C C C C C C C C C C C C C C C C C C C C C C C C C C C C C C C C C C C C C C C C
8 8 8 8 8 8 8 8 8 8 8 8 8 8 8 8 8 8 9 9 8 8 A 8 8 8 8 8 8 8 8 8 8 8 8 A 8 8 9 9 8 8 8 8 8 8 8 8 A A C C C C C C C C C C C C C C C C C C C C C C C C C C C C C C C C C C C C C C C C C C C C C C C C C C
8 8 8 8 8 8 8 8 8 8 8 8 8 8 8 8 8 8 9 9 8 8 A 8 8 8 8 8 8 8 8 8 8 8 8 A 8 8 9 9 8 8 8 8 8 8 8 8 A A C C C C C C C C C C C C C C C C C C C C C C C C C C C C C C C C C C C C C C C C C C C C C C C C C C
8 8 8 8 8 8 8 8 9 9 8 8 8 8 8 A 8 8 8 8 8 8 A 8 8 8 8 8 9 9 A 8 8 8 8 A 8 8 8 8 8 8 8 8 8 8 8 8 A A C C C C C C C C C C C C C C C C C C C C C C C C C C C C C C C C C C C C C C C C C C C C C C C C C C
8 8 8 8 8 8 8 8 9 9 8 8 8 9 9 A 9 9 8 8 8 8 A 8 8 8 8 8 9 9 8 8 8 8 8 A 8 8 8 8 8 8 8 8 8 8 8 8 A A C C C C C C C C C C C C C C C C C C C C C C C C C C C C C C C C C C C C C C C C C C C C C C C C C C
8 8 8 8 8 8 8 8 8 8 8 8 8 9 9 A 9 9 9 9 8 8 A 8 8 8 8 8 8 8 8 8 8 8 8 A 8 8 9 9 8 8 8 8 8 8 8 8 A A C 4 4 4 4 4 4 4 4 4 4 4 4 4 4 4 4 4 4 4 4 4 C C C C C C C C C C C C C C C C C C C C C C C C C C C C
8 8 8 8 8 8 8 8 8 8 8 8 9 9 9 A 9 9 9 9 8 8 A 8 8 8 8 8 A 8 8 8 8 8 8 B 8 8 9 9 8 8 8 8 8 8 8 8 A A C 4 4 4 4 4 4 4 4 4 4 4 4 4 4 4 4 4 4 4 4 4 C C C C C C C C C C C C C C C C C C C C C C C C C C C C
8 8 8 8 8 8 8 8 9 9 8 8 8 9 9 A 9 9 8 8 8 8 A 8 8 8 8 8 9 9 8 8 8 8 8 A 8 8 8 8 8 8 8 8 8 8 8 8 A A C C C C C C C C C C C C C C C C C C C C E C C C C C C C C C C C C C C C C C C C C C C C C C C C C C
8 8 8 8 8 8 8 8 9 9 8 8 8 9 9 A 9 9 8 8 8 8 A 8 8 8 8 8 9 9 8 8 8 8 8 B 8 8 8 8 8 8 8 8 8 8 8 8 A A C C C C C C C C C C C C C C C C C C E E E E E C C C C C C C C C C C C C C C C C C C C C C C C C C C
8 8 8 8 8 8 8 8 8 8 8 8 8 8 8 A 8 8 9 9 8 8 A 8 8 8 8 8 8 8 8 8 8 8 8 A 8 8 9 9 8 8 8 8 8 8 8 8 A A C C C C C C C C C C C C C C C C C E E E E E E E C C C C C C C C C C C C C C C C C C C C C C C C C C
8 8 8 8 8 8 8 8 8 8 8 8 8 8 8 8 8 8 9 9 8 8 A 8 8 8 8 8 8 8 8 8 8 8 8 A 8 8 9 9 8 8 8 8 8 8 8 8 A A C C C C C C C C C C C C C C C C C E E E E E E E C C C C C C C C C C C C C C C C C C C C C C C C C C
A A A B A A A A B A A A A A A A A B A B A A A A A A A A A A A A A A A A A A A A A A A A A A A A A A C C C C C C C C C C C C C C C C E E E E E E E E E C C C C C C C C C C C C C C C C C C C C C C C C C
8 8 8 8 8 8 8 8 9 9 8 8 8 8 8 8 8 8 8 8 8 8 A 8 8 8 8 8 9 9 8 8 8 8 8 A 8 8 8 8 8 8 8 8 8 8 8 8 A A C C C C C C C C C C C C C C C C C E E E E E E E C C C C C C C C C C C C C C C C C C C C C C C C C C
8 8 8 8 8 8 8 8 8 8 8 8 8 8 8 8 8 8 9 9 8 8 A 8 8 8 8 8 8 8 8 8 8 8 8 A 8 8 9 9 8 8 8 8 8 8 8 8 A A C C D D D D D D D D D D D D D D D E E E E E E E C C C C C C C C C C C C C C C C C C C C C C C C C C
8 8 8 8 8 8 8 8 8 8 8 8 8 8 8 8 8 8 9 9 8 8 A 8 8 8 8 8 8 8 8 8 8 8 8 A 8 8 9 9 8 8 8 8 8 8 8 8 A A C C D C C C C C C C C C C C C C D C E E E E E C C C C C C C C C C C C C C C C C C C C C C C C C C C
8 8 8 8 8 8 8 8 9 9 8 8 8 8 8 8 8 8 8 8 8 8 A 8 8 8 8 8 9 9 8 8 8 8 8 A 8 8 8 8 8 8 8 8 8 8 8 8 A A C C D C C C C C C C C C C C C C D C C C E C C C C C C C C C C C C C C C C C C C C C C C C C C C C C
8 8 8 8 8 8 8 8 9 9 8 8 8 8 8 8 8 8 8 8 8 8 A 8 8 8 8 8 9 9 8 8 8 8 8 A 8 8 8 8 8 8 A 8 8 8 8 8 A A C C D C C F G H C C C F G H C C D C C C C C C C C C C C C C C C C C C C C C C C C C C C C C C C C C
8 8 8 8 8 8 8 8 8 8 8 8 8 8 8 8 8 8 9 9 8 8 A 8 8 8 8 8 8 8 8 8 8 8 8 A 8 8 9 9 8 8 8 8 8 8 8 8 A A C C D C C I J I C C C I J I C C D C C C C C C C C C C C C C C C C C C C C C C C C C C C C C C C C C
8 8 8 8 8 8 8 8 8 8 8 8 8 8 8 8 8 8 9 9 8 8 A 8 8 8 8 8 8 8 8 8 8 8 8 A 8 8 9 9 8 8 8 8 8 8 8 8 A A C C D C C I K I C C C I K I C C D C C C C C C C C C C C C C C C C C C C C C C C C C C C C C C C C C
8 8 8 8 8 8 8 8 9 9 8 8 8 8 8 8 8 8 8 8 8 8 A 8 8 8 8 8 9 9 8 8 8 8 8 A 8 8 8 8 8 8 8 8 8 8 8 8 A A C C D C C C C C C C C C C C C C D C C C C C C C C C C C C C C C C C C C C C C C C C C C C C C C C C
8 8 8 8 8 8 8 8 9 9 8 8 8 8 8 8 8 8 8 8 8 8 A 8 8 8 8 8 9 9 8 8 8 8 8 A 8 8 8 8 8 8 8 8 8 8 8 8 A A C C D C C C C C C C C C C C C C D C C C C C C C C C C C C C C C C C C C C C C C C C C C C C C C C C
8 8 8 8 8 8 8 8 8 8 8 8 8 8 8 8 8 8 9 9 8 8 A 8 8 8 8 8 8 8 8 8 8 8 8 A 8 8 9 9 8 8 8 8 8 8 8 8 A A C C D C C C C C C C C C C C C C D C C C C C C C C C C C C C C C C C C C C C C C C C C C C C C C C C
8 8 8 8 8 8 8 8 8 8 8 8 8 8 8 8 8 8 9 9 8 8 A 8 8 8 8 8 8 8 8 8 8 8 8 A 8 8 9 9 8 8 8 8 8 8 8 8 A A C C D C C F G H C C C C C C C C D C C C C C C C C C C C C C C C C C C C C E E E C E E E C C C C C C
A A A A A A A A A A A A A A A A A A A A A A A A A A A A A A A A A A A A A B B A A A A B A A A A A A C C D C C I J I C C C C C C C C D C C C C C C C C C C C C C C C C C C C E E E E C E E E E C C C C C
8 8 8 8 8 8 8 8 9 9 8 8 8 8 8 8 8 8 8 8 A 8 A 8 8 8 8 8 9 9 8 8 8 8 8 A 8 8 8 8 8 8 8 8 8 8 8 8 A A C C D C C I K I C C C C C C C C D C C C C C C C C C C C C C C D C C C C E E E E C E E E E C C C C C
8 8 8 8 8 8 8 8 8 8 8 8 8 8 8 8 8 8 9 9 8 8 A 8 8 8 8 8 8 8 8 8 8 8 8 A 8 8 9 9 8 8 8 8 8 8 8 8 A A C C D C C C C C C C C C C C C C D C C C C C C C C C C C C C C C C C C C E E E E C E E E E C C C C C
8 8 8 8 8 8 8 8 8 8 8 8 8 8 8 8 8 8 9 9 8 8 A 8 8 8 8 8 8 8 8 8 8 8 8 A 8 8 9 9 8 8 8 8 8 8 8 8 A A C C D C C C C C C C C C C C C C D C C C C C C C C C C C C C C C C C C E E E E E C E E E E E C C C C
8 8 8 8 8 8 8 8 9 9 8 8 8 8 8 8 8 8 8 8 8 8 A 8 8 8 8 8 9 9 9 8 8 8 8 A 8 8 8 8 8 8 8 8 8 8 8 8 A A C C D D D D D D D D D D D D D D D C C C C C C C C C C C C C C C C C C C E E E E C E E E E C C C C C
8 8 8 8 8 8 8 8 9 9 8 8 8 8 8 8 8 8 8 8 8 8 A 8 8 8 8 8 9 9 A 9 9 8 8 A 8 8 8 8 8 8 8 8 8 8 8 8 A A C C C C C C C C C C C C C C C C C C C C C C C C C C C C C C C C C C C C E E E E C E E E E C C C C C
8 8 8 8 8 8 8 8 8 8 8 8 8 8 8 8 8 8 9 9 8 8 A 8 8 8 8 9 9 9 A 9 9 9 8 A 8 8 9 9 8 8 8 8 8 A 8 8 A A C C C C C C C C C C C C C C C C C C C C C C C C C C C C C C C C C C C C E E E E C E E E E C C C C C
8 8 8 8 8 8 8 8 8 8 8 8 8 8 8 8 8 8 9 9 8 8 A 8 8 8 8 9 9 9 A 9 9 9 8 A 8 8 9 9 8 8 8 8 8 8 8 8 A A C C C C C C C C C C C D C C C C C C C C C C C C C C C C C C C C C C C C C E E E C E E E C C C C C C
8 8 8 8 8 8 8 8 9 9 8 8 8 8 8 8 8 8 8 8 A 8 A 8 8 8 9 9 9 9 A 9 9 9 9 A 8 8 8 8 8 8 8 8 8 8 8 8 A A C C C C C C C C C C C C C C C C C C C C C C C C C C C C C C C C C C C C C C C C C C C C C C C C C C
8 8 8 8 8 8 8 8 9 9 8 8 8 8 8 8 8 8 8 8 8 8 A 8 8 8 8 9 9 9 A 9 9 9 8 A 8 8 8 8 8 8 8 8 8 8 8 8 A A C C C C C C C C C C C C C C C C C C C C C C C C C C C C C C C C C C C C C C C C C C C C C C C C C C
8 8 8 8 8 8 8 8 8 8 8 8 8 8 8 8 8 8 9 9 8 8 A 8 8 8 8 9 9 9 A 9 9 9 8 A 8 8 9 9 8 8 8 8 8 8 8 8 A A C C C C C C C C C C E C C C C C C C C C C C C C C C C C C C C C C C C C C C C C C C C C C C C C C C
8 8 8 8 8 8 8 8 8 8 8 8 8 8 8 8 8 8 9 9 8 8 B 8 8 8 8 8 9 9 A 9 9 8 8 A 8 8 9 9 8 8 8 8 8 8 8 8 A A C C C C C C C C E E E E E C C C C C C C C C C C C C C C C C C C C C C D C C C C C C C C C C C C C C
8 8 8 8 8 8 8 8 9 9 8 8 8 8 8 8 8 8 8 8 8 8 A 8 8 8 8 8 9 9 9 8 8 8 8 A 8 8 8 8 8 8 8 8 8 8 8 8 A A C C C C C C C C E E E E E C C C C C C C C C C C C C C C C C C C C C C C C C C C C C C C C C C C C C
8 8 8 8 8 8 8 8 9 9 8 8 8 8 8 8 8 8 8 8 8 8 A 8 8 8 8 8 9 9 8 8 8 8 8 A 8 8 8 8 8 8 8 8 8 8 8 8 A A C C C C C C C E E E E E E E C C C C C C C C C C C C C C C C C C C C C C C C C C C C C C C C C C C C
8 8 8 8 8 8 8 8 8 8 8 8 8 8 8 8 8 8 9 9 8 8 A 8 8 8 8 8 8 8 8 8 8 8 8 A 8 8 9 9 8 8 8 8 8 8 8 8 A A C C C C C C C C E E E E E C C C C C C C C C C C C C C C C C C C C C C C C C C D C C C C C C C C C C
8 8 8 8 8 8 8 8 A 8 8 8 8 8 8 8 8 8 9 9 8 8 A 8 8 8 8 8 8 8 8 8 8 8 8 A 8 8 9 9 8 8 8 8 8 8 8 8 A A C C C C C C C C E E E E E C C C C C C C C C C C C C C C C C C C C C C C C C C C C C C C C C C C C C
8 8 8 8 8 8 9 9 A 9 9 8 8 8 8 8 8 8 8 8 8 8 A 8 8 8 8 8 9 9 8 8 8 8 8 A 8 8 8 8 8 8 8 8 8 8 8 8 A A C C C C C C C C C C E C C C C C C C C C C C C C C C C C C C C C C C C C C C C C C C C C C C C C C C
8 8 8 8 8 8 9 9 A 9 9 8 8 8 8 8 8 8 8 8 8 8 A 8 8 8 8 8 9 9 8 8 8 8 8 A 8 8 8 8 8 8 8 8 8 8 8 8 A A C C C C C C C C C C C C C C C C C C C C C C C C C C C C C C C C C C C C C C C C C C C C C C C C C C
8 8 8 8 8 9 9 9 A 9 9 9 8 8 8 8 8 8 9 9 8 8 A 8 8 8 8 8 8 8 8 8 8 8 8 A 8 8 9 9 8 8 8 8 8 8 8 8 A A C C C C C C C C C C C C C C C C C C C C C C C C C C C C C C C C C C C C C C C C C C C C C C C C C C
8 8 8 8 8 8 9 9 A 9 9 8 8 8 8 8 8 8 9 9 8 8 A 8 8 8 8 8 8 8 8 8 8 8 8 A 8 8 9 9 8 8 8 8 8 8 8 8 A A C C C C C C D C C C C C C C C C C C C C C C C C C C C D C C C C C C C C C C C C C C C C C C C C C C
8 8 8 8 8 8 9 9 A 9 9 8 8 8 8 8 8 8 8 8 8 8 A 8 8 8 8 8 9 9 8 8 8 8 8 A 8 8 8 8 8 8 8 8 8 8 8 8 A A C C C C C C C C C C C C C C C C C C C C C C C C C C C C C C C C C C C C C C C C C C C C C C C C C C
8 8 8 8 8 8 8 8 A 9 8 8 8 8 8 8 8 8 8 8 8 8 A 8 8 8 8 8 9 9 8 8 8 8 8 A 8 8 8 8 8 8 8 8 8 8 8 8 A A C C C C C C C C C C C C C C C C C C C C C C C C C C C C C C C C C C C C C C C C C C C C C C C C C C
8 8 8 8 8 8 8 8 8 8 8 8 8 8 8 8 8 8 9 9 8 8 A 8 8 8 8 8 8 8 8 8 8 8 8 A 8 8 9 9 8 8 8 8 8 8 8 8 A A C C C C C C C C C C C C C C C C C C C C C C C C C C C C C C C C C C C C C C C C C C C C C C C C C C
8 8 8 8 8 8 8 8 8 8 8 8 8 8 8 8 8 8 9 9 8 8 A 8 8 8 8 8 8 8 8 8 8 8 8 A 8 8 9 9 8 8 8 8 8 8 8 8 A A C C C C C C C C C C C C C C C C C C C C C C C C C C C C C C C C C C C C C C C C C C C C C C C C C C
8 8 8 8 8 8 8 8 9 9 8 8 8 8 8 8 8 8 8 8 8 8 A 8 8 8 8 8 9 9 8 8 8 8 8 A 8 8 8 8 8 8 8 8 8 8 8 8 A A C C C C C C C C C C C C C C C C C C C C C C C C C C C C C C C C C C C C C C C C C C C C C C C C C C
8 8 8 8 8 8 8 8 9 9 8 8 8 8 8 8 8 8 8 8 8 8 A 8 8 8 8 8 9 9 8 8 8 8 8 A 8 8 8 8 8 8 8 8 8 8 8 8 A A C C C C C C C C C C C C C C C C C C C C C C C C C C C C C C C C C C C C C C C C C C C C C C C C C C
8 8 8 8 8 8 8 8 8 8 8 8 8 8 8 8 8 8 9 9 8 8 A 8 8 8 8 8 8 8 8 8 8 8 8 A 8 8 9 9 8 8 8 8 8 8 8 8 A A C C C C C C C C C C C C C C C C C C C C C C C C C C C C C C C C C C C C C C C C C C C C C C C C C C
8 8 8 8 8 8 8 8 8 8 8 8 8 8 8 8 8 8 9 9 8 8 A 8 8 8 8 8 8 8 8 8 8 8 8 A 8 8 9 9 8 8 8 8 8 8 8 8 A A C C C C C C C C C C C C C C C C C C C C C C C C C C C C C C C C C C C C C C C C C C C C C C C C C C
R 11 20 1 1
R 12 60 1 1
R 20 80 1 1
R 26 35 1 1
R 28 55 1 1
R 40 25 2 1
R 42 65 2 1
R 52 30 2 1
R 59 80 2 1
R 60 50 2 1
R 73 20 3 1
R 78 45 3 1
R 82 70 3 1
R 89 35 3 1
R 92 85 3 1
