100 100
0 0 0 0 3 0 0 0 2 1 1 1 2 0 0 0 3 0 0 0 0 0 0 0 0 0 0 0 0 0 C C C C C C C C C C C C C C C C C C C C C C C C C C C C C C C C C C C C C C C C 7 7 7 7 7 7 7 4 4 4 4 4 4 4 4 4 4 4 4 4 4 4 4 4 4 4 4 4 4 4
0 0 0 0 0 0 0 0 2 1 1 1 2 0 0 0 0 0 0 0 0 0 0 0 0 0 0 0 0 0 C C C C C C C C C C C C C C C C C C C C C C C C C C C C C C C C C C C C C C C C 7 7 7 7 7 7 7 4 4 4 4 4 4 4 4 4 4 4 4 4 4 4 4 4 4 4 4 4 4 4
0 0 0 0 0 0 0 0 0 2 1 1 1 2 0 0 0 0 0 0 0 0 0 0 0 0 0 0 0 0 C C C C C C C C C C C C C C C C C C C C C C C C C C C C C C C C C C C C C C C C 7 7 7 7 7 7 7 4 4 4 4 4 4 4 4 4 4 4 4 4 4 4 4 4 4 4 4 4 4 4
0 0 0 0 0 0 0 0 0 2 1 1 1 2 0 0 0 0 0 0 0 0 0 0 0 0 0 0 0 0 C C C C C C C C C C C C C C C C C C C C C C C C C C C C C C C C C C C C C C C C 7 7 7 7 7 7 7 4 4 4 4 4 4 4 4 4 4 4 4 4 4 4 4 4 4 4 4 4 4 4
0 0 0 0 0 0 0 0 0 0 2 1 1 1 2 0 0 0 0 0 0 0 0 0 0 0 0 0 0 0 C C C C C C C C C C C C C C C C C C C C C C C C C C C C C C C C C C C C C C C C 7 7 7 7 7 7 7 4 4 4 4 4 4 4 4 4 4 4 4 4 4 4 4 4 4 4 4 4 4 4
0 0 0 0 0 0 0 0 0 0 2 1 1 1 2 0 0 0 0 0 0 0 0 0 0 0 0 0 0 0 C C C C C C C C C C C C C C C C C C C C C C C C C C C C C C C C C C C C C C C C 4 4 4 4 4 4 4 4 4 4 4 4 4 4 4 4 4 4 4 4 4 4 4 4 4 4 4 4 7 7
0 0 0 0 0 0 0 3 0 0 0 2 1 1 1 2 0 0 0 3 0 0 0 0 0 0 0 0 0 0 C C C C C C C C C C C C C C C C C C C C C C C C C C C C C C C C C C C C C C C C 4 4 4 4 4 4 4 4 4 4 4 4 4 4 4 4 4 4 4 4 4 4 4 4 4 4 4 4 7 7
0 0 0 0 0 0 0 0 0 0 0 2 1 1 1 2 0 0 0 0 0 0 0 0 0 0 0 0 0 0 C C C C C C C C C C C C C C C C C C C C C C C C C C C C C C C C C C C C C C C C 4 4 4 4 4 4 4 4 4 4 4 4 4 4 4 4 4 4 4 4 4 4 4 4 4 4 4 4 7 7
0 0 0 0 0 0 0 0 0 0 0 2 1 1 1 2 0 0 0 0 0 0 0 0 0 0 0 0 0 0 C C C C C C C C C C C C C C C C C C C C C C C C C C C C C C C C C C C C C C C C 4 4 4 4 4 4 4 4 4 4 4 4 4 4 4 4 4 4 4 4 4 4 4 4 4 4 4 4 7 7
0 0 0 0 0 0 0 0 0 0 0 0 2 1 1 1 2 0 0 0 0 0 0 0 0 0 0 0 0 0 C C C C C C C C C C C C C C C C C C C C C C C C C C C C C C C C C C C C C C C C 4 4 4 4 4 4 4 4 4 4 6 4 4 4 4 4 4 4 4 4 4 4 4 4 4 4 4 4 7 7
0 0 0 0 0 0 0 0 0 0 0 0 2 1 1 1 2 0 0 0 0 0 0 0 0 0 0 0 0 0 C C C C C C C C C C C C C C C C C C C C C C C C C C C C C C C C C C C C C C C C 4 4 4 4 4 4 4 6 6 6 6 6 6 6 4 4 4 4 4 4 4 7 7 7 7 7 7 7 4 4
0 0 0 0 0 0 0 0 0 0 0 0 2 1 1 1 2 0 0 0 0 0 0 0 0 0 0 0 0 0 C C C C C C C C C C C C C C C C C C C C C C C C C C C C C C C C C C C C C C C C 4 4 4 4 4 4 6 6 6 6 6 6 6 6 6 4 4 4 4 4 4 7 7 7 7 7 7 7 4 4
0 0 0 0 0 0 0 0 3 0 0 0 2 1 1 1 2 0 0 0 3 0 0 0 0 0 0 0 0 0 C C C C C C C C C C C C C C C C C C C C C C C C C C C C C C C C C C C C C C C C 4 4 4 4 4 6 6 6 6 6 6 6 6 6 6 6 4 4 4 4 4 7 7 7 7 7 7 7 4 4
0 0 0 0 0 0 0 0 0 0 0 0 2 1 1 1 2 0 0 0 0 0 0 0 0 0 0 0 0 0 C C C C C C C C C C C C C C C C C C C C C C C C C C C C C C C C C C C C C C C C 4 4 4 4 4 6 6 6 6 6 6 6 6 6 6 6 4 4 4 4 4 7 7 7 7 7 7 7 4 4
0 0 0 0 0 0 0 0 0 0 0 0 2 1 1 1 2 0 0 0 0 0 0 0 0 0 0 0 0 0 C C C C C C C C C C C C C C C C C C C C C C C C C C C C C C C C C C C C C C C C 4 4 4 4 4 6 6 6 6 6 6 6 6 6 6 6 4 4 4 4 4 7 7 7 7 7 7 7 4 4
0 0 0 0 0 0 0 0 0 0 0 0 2 1 1 1 2 0 0 0 0 0 0 0 0 0 0 0 0 0 C C C C C C C C C C C C C C C C C C C C C C C C C C C C C C C C C C C C C C C C 4 4 4 4 6 6 6 6 6 6 6 6 6 6 6 6 6 7 7 7 7 4 4 4 4 4 4 4 4 4
0 0 0 0 0 0 0 0 0 0 0 0 2 1 1 1 2 0 0 0 0 0 0 0 0 0 0 0 0 0 C C C C C C C C C C C C C C C C C C C C C C C C C C C C C C C C C C C C C C C C 4 4 4 4 4 6 6 6 6 6 6 6 6 6 6 6 7 7 7 7 7 4 4 4 4 4 4 4 4 4
0 0 0 0 0 0 0 0 0 0 0 0 2 1 1 1 2 0 0 0 0 0 0 0 0 0 0 0 0 0 C C C C C C C C C C C C C C C C C C C C C C C C C C C C C C C C C C C C C C C C 4 4 4 4 4 6 6 6 6 6 6 6 6 6 6 6 7 7 7 7 7 4 4 4 4 4 4 4 4 4
0 0 0 0 0 0 0 0 3 0 0 0 2 1 1 1 2 0 0 0 3 0 0 0 0 0 0 0 0 0 C C C C C C C C C C C C C C C C C C C C C C C C C C C C C C C C C C C C C C C C 4 4 4 4 4 6 6 6 6 6 6 6 6 6 6 6 7 7 7 7 7 4 4 4 4 4 4 4 4 4
0 0 0 0 0 0 0 0 0 0 0 0 2 1 1 1 2 0 0 0 0 0 0 0 0 0 0 0 0 0 C C C C C C C C C C C C C C C C C C C C C C C C C C C C C C C C C C C C C C C C 4 4 4 4 4 4 6 6 6 6 6 6 6 6 6 7 7 7 7 7 7 4 4 4 4 4 4 4 4 4
0 0 2 2 2 2 2 2 2 2 2 2 1 1 1 2 0 0 0 0 0 0 0 0 0 0 0 0 0 0 C C C C C C C C C C C C C C C C C C C C C C C C C C C C C C C C C C C C C C C C 4 4 4 4 4 4 4 6 6 6 6 6 6 6 4 4 4 4 4 4 4 4 4 4 4 4 4 4 4 4
0 0 2 2 2 2 2 2 2 2 2 2 1 1 1 2 0 0 0 0 0 0 0 0 0 0 0 0 0 0 C C C C C C C C C C C C C C C C C C C C C C C C C C C C C C C C C C C C C C C C 4 4 4 4 4 4 4 7 7 7 6 7 7 7 4 4 4 4 4 4 4 4 4 4 4 4 4 4 4 4
0 0 2 2 2 2 2 2 2 2 2 2 1 1 1 2 0 0 0 0 0 0 0 0 0 0 0 0 0 0 C C C C C C C C C C C C C C C C C C C C C C C C C C C C C C C C C C C C C C C C 4 4 4 4 4 4 4 7 7 7 7 7 7 7 4 4 4 4 4 4 4 4 4 4 4 4 4 4 4 4
0 0 2 2 2 2 2 2 2 2 2 2 1 1 2 0 0 0 0 0 0 0 0 0 0 0 0 0 0 0 C C C C C C C C C C C C C C C C C C C C C C C C C C C C C C C C C C C C C C C C 4 4 4 4 4 4 4 7 7 7 7 7 7 7 4 4 4 4 4 4 4 4 4 4 4 4 4 4 4 4
0 0 2 2 2 2 2 2 2 2 2 2 1 1 2 0 0 0 3 0 0 0 0 0 0 0 0 0 0 0 C C C C C C C C C C C C C C C C C C C C C C C C C C C C C C C C C C C C C C C C 4 4 4 4 4 4 4 7 7 7 7 7 7 7 4 4 4 4 4 4 4 4 4 4 4 4 4 4 4 4
0 0 2 2 2 2 2 2 2 2 2 2 1 2 0 0 0 0 0 0 0 0 0 0 0 0 0 0 0 0 C C C C C C C C C C C C C C C C C C C C C C C C C C C C C C C C C C C C C C C C 7 7 7 7 7 7 7 4 4 4 4 4 4 4 4 4 4 4 4 4 4 4 4 4 4 4 4 4 4 4
0 0 2 2 2 2 2 2 2 2 2 2 1 2 0 0 0 0 0 0 0 0 0 0 0 0 0 0 0 0 C C C C C C C C C C C C C C C C C C C C C C C C C C C C C C C C C C C C C C C C 7 7 7 7 7 7 7 4 4 4 4 4 4 4 4 4 4 4 4 4 4 4 4 4 4 4 4 4 4 4
0 0 2 2 2 2 2 2 2 2 2 2 2 0 0 0 0 0 0 0 0 0 0 0 0 0 0 0 0 0 C C C C C C C C C C C C C C C C C C C C C C C C C C C C C C C C C C C C C C C C 7 7 7 7 7 7 7 4 4 4 4 4 4 4 4 4 4 4 4 4 4 4 4 4 4 4 4 4 4 4
0 0 2 2 2 2 2 2 2 2 2 2 0 2 0 0 0 0 0 0 0 0 0 0 0 0 0 0 0 0 C C C C C C C C C C C C C C C C C C C C C C C C C C C C C C C C C C C C C C C C 7 7 7 7 7 7 7 4 4 4 4 4 4 4 4 4 4 4 4 4 4 4 4 4 4 4 4 4 4 4
0 0 2 2 2 2 2 2 2 2 2 2 2 0 0 0 0 0 0 0 0 0 0 0 0 0 0 0 0 0 C C C C C C C C C C C C C C C C C C C C C C C C C C C C C C C C C C C C C C C C 7 7 7 7 7 7 7 4 4 4 4 4 4 4 4 4 4 4 4 4 4 4 4 4 4 4 4 4 4 4
0 0 2 2 2 2 2 2 2 2 2 2 2 0 0 0 3 0 0 0 0 0 0 0 0 0 0 0 0 0 C C C C C C C C C C C C C C C C C C C C C C C C C C C C C C C C C C C C C C C C 4 4 4 4 4 4 4 4 4 4 4 4 4 4 4 4 4 4 4 4 4 4 4 4 4 4 4 4 7 7
0 0 2 2 2 2 2 2 2 2 2 2 0 0 0 0 0 0 0 0 0 0 0 0 0 0 0 0 0 0 C C C C C C C C C C C C C C C C C C C C C C C C C C C C C C C C C C C C C C C C 4 4 4 4 4 4 4 4 4 4 4 4 4 4 4 4 4 4 4 4 4 4 4 4 4 4 4 4 7 7
0 0 2 2 2 2 2 2 2 2 2 2 0 0 0 0 0 0 0 0 0 0 0 0 0 0 0 0 0 0 C C C C C C C C C C C C C C C C A A A A A A A A C C C C C C C C C C C C C C C C 4 4 4 4 4 4 4 4 4 4 4 4 4 4 4 4 4 4 4 4 4 4 4 4 4 4 4 4 7 7
0 0 2 2 2 2 2 2 2 2 2 2 0 0 0 0 0 0 0 0 0 0 0 0 0 0 0 0 0 0 C C C C C C C C C C C C C C C C A A A A C A A A C C C C C C C C C C C C C C C C 4 4 4 4 4 4 4 4 4 4 4 4 4 4 4 4 4 4 4 4 4 4 4 4 4 4 4 4 7 7
0 0 2 2 2 2 2 2 2 2 2 2 0 0 0 0 0 0 0 0 0 0 0 0 0 0 0 0 0 0 C C E C C C C C E C C C C C E C A A A C E C A A C C E C C C C C E C C C C C C C 4 4 4 4 4 4 4 4 4 4 4 4 4 4 4 4 4 4 4 4 4 4 4 4 4 4 4 4 7 7
0 0 2 2 2 2 2 2 2 2 2 2 0 0 0 0 0 0 0 0 0 0 0 0 0 0 0 0 0 0 C C C C C C C C C C C C C C C C A A A A C A A A C C C C C C C C C C C C C C C C 4 4 4 4 4 4 4 4 4 4 4 4 4 4 4 4 4 4 4 4 4 7 7 7 7 7 7 7 4 4
0 3 0 0 0 2 1 1 1 2 0 0 0 3 0 0 0 0 0 0 0 0 0 0 0 0 0 0 0 0 C C C C C C C C C C C C C C C C A A A A A A A A C C C C C C C C C C C C C C C C 4 4 4 4 4 4 4 4 4 4 4 4 4 4 4 4 4 4 4 4 4 7 7 7 7 7 7 7 4 4
0 0 0 0 2 1 1 1 2 0 0 0 0 0 0 0 0 0 0 0 0 0 0 0 0 0 0 0 0 0 C C C C C C C C C D D D D D D D A A A A A A A A C C C D D D D D D D C C C C C C 4 4 4 4 4 4 4 4 4 4 4 4 4 4 4 4 4 4 4 4 4 7 7 7 7 7 7 7 4 4
0 0 0 0 2 1 1 1 2 0 0 0 0 0 0 0 0 0 0 0 0 0 0 0 0 0 0 0 0 0 C C C C C C C C C D F G G G H D A A A A A A A A C C C D F G G G H D C C C C C C 4 4 4 4 4 4 4 4 4 4 4 4 4 4 4 4 4 4 4 4 4 7 7 7 7 7 7 7 4 4
0 0 0 0 2 1 1 1 2 0 0 0 0 0 0 0 0 0 0 0 0 0 0 0 0 0 0 0 0 0 C C C C C C C C C D I J J J I D A A A A C A A A C C C D I J J J I D C C C C C C 4 4 4 4 4 4 4 4 4 4 4 4 4 4 4 4 4 4 4 4 4 7 7 7 7 7 7 7 4 4
0 0 0 0 2 1 1 1 2 0 0 0 0 0 0 0 0 0 0 0 0 0 0 0 0 0 0 0 0 0 C C E C C C D C E D I J J J I D A A A C E C A A C C E D I J J J I D D C C C C C 2 2 2 2 9 2 2 2 2 B 2 2 2 2 9 9 9 9 9 9 B 2 2 2 2 2 2 2 2 2
0 0 0 0 2 1 1 1 2 0 0 0 0 0 0 0 0 0 0 0 0 0 0 0 0 0 0 0 0 0 C C C C C C C C C D I J K J I D A A A A C A A A C C C D I J K J I D C C C C C C 2 8 8 B 8 2 8 8 8 8 2 8 8 8 9 9 9 9 9 9 2 8 8 8 8 B 8 8 8 8
3 0 0 0 2 1 1 1 2 0 0 0 3 0 0 0 0 0 0 0 0 0 0 0 0 0 0 0 0 0 C C C C C C C C C D D D A D D D A A A A A A A A C C C D D D D D D D C C C C C C 2 8 8 8 8 2 8 8 B 8 2 8 8 8 9 9 9 9 9 9 2 8 8 8 8 2 8 8 8 8
0 0 0 0 2 1 1 1 2 0 0 0 0 0 0 0 0 0 0 0 0 0 0 0 0 0 0 0 0 0 C C C C C C C C C C C C A C C C A A A A A A A A C C C C C C C C C C C C C C C C 2 8 B 8 8 2 8 8 8 8 2 8 8 B 9 9 9 9 9 9 2 8 8 8 B 2 8 8 8 8
0 0 0 0 2 1 1 1 2 0 0 0 0 0 0 0 0 0 0 0 0 0 0 0 0 0 0 0 0 0 C C C C C C D C C C C C A C C C A A A A A A A A C C C C C C C C C C D C C C C C 2 8 8 8 8 2 8 9 9 9 9 9 9 9 8 2 8 8 B 8 2 8 8 8 8 2 8 8 8 B
0 0 0 0 2 1 1 1 2 0 0 0 0 0 0 0 0 0 0 0 0 0 0 0 0 0 0 0 0 0 C C C C C C C C C C C C A C C C A A A A C A A A C C C C C C C C C C C C C C C C 2 B 2 2 2 2 2 2 9 9 9 9 9 9 2 2 2 2 2 2 2 2 2 B 2 2 2 2 2 2
0 0 0 0 2 1 1 1 2 0 0 0 0 0 0 0 0 0 0 0 0 0 0 0 0 0 0 0 A A A C E C A A A C E C A A A C E C A A A C E C A A A C E C A A A C E C A A A A A A 2 2 2 2 2 2 2 2 9 9 9 9 9 9 8 2 8 B 8 8 2 8 8 8 8 2 8 8 B 8
0 0 0 0 2 1 1 1 2 0 0 0 0 0 0 0 0 0 0 0 0 0 0 0 0 0 0 0 A A A A C A A A A A C A A A A A C A A A A A C A A A A A C A A A A A C A A A A A A A 2 2 2 2 2 2 2 2 9 9 9 9 9 9 8 2 8 8 8 8 2 8 B 8 8 2 8 8 8 8
3 0 0 0 2 1 1 1 2 0 0 0 3 0 0 0 0 0 0 0 0 0 0 0 0 0 0 0 A A A A A A A A D A A A A A A A A A A A A A A A A A A A A A A A A A A A D A A A A A 2 2 2 2 2 2 2 2 8 8 9 8 8 8 8 2 B 8 8 8 2 8 8 8 8 2 8 B 8 8
0 0 0 0 0 2 1 1 1 2 0 0 0 0 0 0 0 0 0 0 0 0 0 0 0 0 0 0 A A A A A A A A A A A A A A A A A A A A A A A A A A A A A A A A A A A A A A A A A A 2 2 2 2 2 2 2 2 8 8 B 8 8 8 8 2 8 8 8 8 2 B 8 8 8 2 8 8 8 8
0 0 0 0 0 2 1 1 1 2 0 0 0 0 0 0 0 0 0 0 0 0 0 0 0 0 0 0 A A A A A A A A A A A A A A A A A A A A A A A A A A A A A A A A A A A A A A A A A A 2 2 2 2 2 2 2 2 2 2 2 2 2 2 2 B 2 2 2 2 2 2 2 2 2 2 B 2 2 2
0 0 0 0 0 0 2 1 1 1 2 0 0 0 0 0 0 0 0 0 0 0 0 0 0 0 0 0 A A A A C A A A A A C A A A A A A A A A A A A A A A A A A A A A A A C A A A A A A A 2 2 2 2 2 2 2 2 8 B 2 8 8 8 8 2 8 8 8 8 B 8 8 8 8 2 8 8 8 8
0 0 0 0 0 0 2 1 1 1 2 0 0 0 0 0 0 0 0 0 0 0 0 0 0 0 0 0 A A A C E C A A D C E C A A A C E C A A A C E C A A A C E C A A A C E C D A A A A A 2 2 2 2 2 2 2 2 8 8 2 8 8 9 B 2 8 8 8 8 2 8 8 8 8 B 8 8 8 8
0 0 0 0 0 0 0 2 1 1 1 2 0 0 0 0 0 0 0 0 0 0 0 0 0 0 0 0 A A A A C A A A A A C A A A A A C A A A A A C A A A A A C A A A A A C A A A A A A A 2 2 2 2 2 2 2 2 B 8 2 8 8 8 8 2 8 8 8 B 2 8 8 8 8 2 8 8 8 8
0 0 0 3 0 0 0 2 1 1 1 2 0 0 0 3 0 0 0 0 0 0 0 0 0 0 0 0 0 0 C C C C C C C C C C C C C C C C A A A A A A A A C C C C C C C C C C C C C C C C 9 9 B 8 8 2 8 8 8 8 2 8 8 B 8 2 8 8 8 8 2 8 8 8 B 2 8 8 8 8
0 0 0 0 0 0 0 2 0 0 0 0 0 2 0 0 0 0 0 0 0 0 0 0 0 0 0 0 0 0 C C C C C C C C C C C C C C C C A A A A A A A A C C C C C C C C C C C C C C C C 9 9 2 2 2 2 2 B 2 2 2 2 2 2 2 2 2 2 B 2 2 2 2 2 2 2 2 2 2 B
0 0 0 0 0 0 0 0 2 1 1 1 2 0 0 0 0 0 0 0 0 0 0 0 0 0 0 0 0 0 C C C C C C D C C C C C C C C C A A A A A A A A C C C C C C C C C C D C C C C C 2 B 8 8 8 2 8 8 8 8 2 8 B 8 8 2 9 8 8 8 2 8 8 B 8 2 9 9 9 9
0 0 0 0 0 0 0 0 2 1 1 1 2 0 0 0 0 0 0 0 0 0 0 0 0 0 0 0 0 0 C C C C C C C C C C C C C C C C A A A A C A A A C C C C C C C C C C C C C C C C 2 8 8 8 8 2 B 8 8 8 2 8 8 8 8 2 8 B 8 8 2 8 8 8 8 2 9 9 9 9
0 0 0 0 0 0 0 0 2 1 1 1 2 0 0 0 0 0 0 0 0 0 0 0 0 0 0 0 0 0 C C E C C C C C E C C C C C E C A A A C E C A A C C E C C C C C E C C C C C C C B 8 8 8 8 2 8 8 8 8 2 B 8 8 8 2 8 8 8 8 2 8 B 8 8 2 9 9 9 9
0 0 0 0 0 0 0 0 0 2 1 1 1 2 0 0 0 0 0 0 0 0 0 0 0 0 0 0 0 0 C C C C C C C C C C C C C C C C A A A A C A A A C C C C C C C C C C C C C C C C 2 8 8 8 8 B 8 8 8 8 2 8 8 8 8 2 B 8 8 8 2 8 8 8 8 2 9 9 9 9
0 0 0 0 0 3 0 0 0 2 1 1 1 2 0 0 0 3 0 0 0 0 0 0 0 0 0 0 0 0 C C C C C C D C C C C C C C C C A A A A A A A A C C C C C C A C C C D C C C C C 2 2 2 2 2 2 2 2 2 2 B 2 2 2 2 2 2 2 2 9 9 9 9 9 9 9 2 2 2 2
0 0 0 0 0 0 0 0 0 0 2 1 1 1 2 0 0 0 0 0 0 0 0 0 0 0 0 0 0 0 C C C C C C C C C C C C C C C C A A A A A A A A C C C C C C A C C C C C C C C C 2 8 8 8 B 2 8 8 8 8 2 8 8 8 8 B 8 8 8 8 9 9 9 9 9 9 B 8 8 8
0 0 0 0 0 0 0 0 0 0 2 1 1 1 2 0 0 0 0 0 0 0 0 0 0 0 0 0 0 0 C C C C C C C C C C C C C C C C A A A A A A A A C C C C C C A C C C C C C C C C 2 8 8 8 8 2 8 8 8 B 2 8 8 8 8 2 8 8 8 8 9 9 9 9 9 9 8 8 8 8
0 0 0 0 0 0 0 0 0 0 0 2 1 1 1 2 0 0 0 0 0 0 0 0 0 0 0 0 0 0 C C C C C C C C C C C C C C C C A A A A C A A A C C C C C C A C C C C C C C C C 2 8 8 B 8 2 8 8 8 8 2 8 8 8 B 2 8 8 8 8 9 9 9 9 9 9 8 8 8 8
0 0 0 0 0 0 0 0 0 0 0 2 1 1 1 2 0 0 0 0 0 0 0 0 0 0 0 0 0 0 C C E C C C C C E C C C C C E C A A A C E C A A C C E C C C C C E C C C C C C C 2 8 8 8 8 2 8 8 B 8 2 8 8 8 9 9 9 9 9 9 2 8 8 8 8 2 8 8 8 8
0 0 0 0 0 0 0 0 0 0 0 0 2 1 1 1 2 0 0 0 0 0 0 0 0 0 0 0 0 0 C C C C C C C C C C C C C C C C A A A A C A A A C C C C C C C C C C C C C C C C 2 2 B 2 2 2 2 2 2 2 2 2 2 B 9 9 9 9 9 9 2 2 2 2 B 2 2 2 2 2
0 0 0 0 0 0 0 0 3 0 0 0 2 1 1 1 2 0 0 0 3 0 0 0 0 0 0 0 0 0 C C C C C C C C C C C C C C C C A A A A A A A A C C C C C C C C C C C C C C C C 2 8 8 8 8 2 8 B 8 8 2 8 8 8 9 9 9 9 9 9 2 8 8 8 8 2 8 8 8 B
0 0 0 0 0 0 0 0 0 0 0 0 2 1 1 1 2 0 0 0 0 0 0 0 0 0 0 0 0 0 C C C C C C C C C C C C C C C C A A A A A A A A C C C C C C C C C C C C C C C C 2 B 8 8 8 2 8 8 8 8 2 8 B 8 9 9 9 9 9 9 2 8 8 B 8 2 8 8 8 8
0 0 0 0 0 0 0 0 0 0 0 0 2 1 1 1 2 0 0 0 0 0 0 0 0 0 0 0 0 0 C C C C C C C C C C C C C C C C A A A A A A A A C C C C C C C C C C C C C C C C 2 8 8 8 8 2 B 8 9 9 9 9 9 9 8 2 8 B 8 8 2 8 8 8 8 2 8 8 B 8
0 0 0 0 0 0 0 0 0 0 0 0 2 1 1 1 2 0 0 0 0 0 0 0 0 0 0 0 0 0 C C C C C C C C C C C C C C C C A A A A A A A A C C C C C C C C C C C C C C C C B 8 8 8 8 2 8 8 9 9 9 9 9 9 8 2 8 8 8 8 2 8 B 8 8 2 8 8 8 8
0 0 0 0 0 0 0 0 0 0 0 0 2 1 1 1 2 0 0 0 0 0 0 0 0 0 0 0 0 0 C C C C C C C C C C C C C C C C A A A A A A A A C C C C C C C C C C C C C C C C 4 4 4 4 4 4 4 7 7 7 7 7 7 7 4 4 4 4 4 4 4 4 4 4 4 4 4 4 4 4
0 0 0 0 0 0 0 0 0 0 0 0 2 1 1 1 2 0 0 0 0 0 0 0 0 0 0 0 0 0 C C C C C C C C C C C C C C C C A A A A A A A A C C C C C C C C C C C C C C C C 4 4 4 4 4 4 4 7 7 7 7 7 7 7 4 4 4 4 4 4 4 4 4 4 4 4 4 4 4 4
0 0 0 0 0 0 0 0 3 0 0 0 2 1 1 1 2 0 0 0 3 0 0 0 0 0 0 0 0 0 C C C C C C C C C C C C C C C C A A A A A A A A C C C C C C C C C C C C C C C C 4 4 4 4 4 4 4 7 7 7 7 7 7 7 4 4 4 4 4 4 4 4 4 4 4 4 4 4 4 4
0 0 0 0 0 0 0 0 0 0 0 0 2 1 1 1 2 0 0 0 0 0 0 0 0 0 0 0 0 0 C C C C C C C C C C C C C C C C A A A A A A A A C C C C C C C C C C C C C C C C 4 4 4 4 4 4 4 7 7 7 7 7 7 7 4 4 4 4 4 4 4 4 4 4 4 4 4 4 4 4
0 0 0 0 0 0 0 0 0 0 0 0 2 1 1 1 2 0 0 0 0 0 0 0 0 0 0 0 0 0 C C C C C C C C C C C C C C C C A A A A A A A A C C C C C C C C C C C C C C C C 4 4 4 4 4 4 4 7 7 7 7 7 7 7 4 4 4 4 4 4 4 4 4 4 4 4 4 4 4 4
0 0 0 0 0 0 0 0 0 0 0 0 2 1 1 1 2 0 0 0 0 0 0 0 0 0 0 0 0 0 C C C C C C C C C C C C C C C C A A A A A A A A C C C C C C C C C C C C C C C C 7 7 7 7 7 7 7 4 4 4 4 4 4 4 4 4 4 4 4 4 4 4 4 4 4 4 4 4 4 4
0 0 0 0 0 0 0 0 0 0 0 0 2 1 1 1 2 0 0 0 0 0 0 0 0 0 0 0 0 0 C C C C C C C C C C C C C C C C C C C C C C C C C C C C C C C C C C C C C C C C 7 7 7 7 7 7 7 4 4 4 4 4 4 4 4 4 4 4 4 4 4 4 4 4 4 4 4 4 4 4
0 0 0 0 0 0 0 0 0 0 0 2 1 1 1 2 0 0 0 0 0 0 0 0 0 0 0 0 0 0 C C C C C C C C C C C C C C C C C C C C C C C C C C C C C C C C C C C C C C C C 7 7 7 7 7 7 7 4 4 4 4 4 4 4 4 4 4 4 4 4 4 4 4 4 4 4 4 4 4 4
0 0 0 0 0 0 0 3 0 0 0 2 1 1 1 2 0 0 0 3 0 0 0 0 0 0 0 0 0 0 C C C C C C C C C C C C C C C C C C C C C C C C C C C C C C C C C C C C C C C C 7 7 7 7 7 7 7 4 4 4 4 4 4 4 4 4 4 4 4 4 4 4 4 4 4 4 4 4 4 4
0 0 0 0 0 0 0 0 0 0 0 2 1 1 1 2 0 0 0 0 0 0 0 0 0 0 0 0 0 0 C C C C C C C C C C C C C C C C C C C C C C C C C C C C C C C C C C C C C C C C 7 7 7 7 7 7 7 4 4 4 4 4 4 4 4 4 4 4 4 4 4 4 4 4 4 4 4 4 4 4
0 0 0 0 0 0 0 0 0 0 2 1 1 1 2 0 0 0 0 0 0 0 0 0 0 0 0 0 0 0 C C C C C C C C C C C C C C C C C C C C C C C C C C C C C C C C C C C C C C C C 4 4 4 4 4 4 4 4 4 4 4 4 4 4 4 6 4 4 4 4 4 4 4 4 4 4 4 4 7 7
0 0 0 0 0 0 0 0 0 0 2 1 1 1 2 0 0 0 0 0 0 0 0 0 0 0 0 0 0 0 C C C C C C C C C C C C C C C C C C C C C C C C C C C C C C C C C C C C C C C C 4 4 4 4 4 4 4 4 4 4 4 4 6 6 6 6 6 6 6 4 4 4 4 4 4 4 4 4 7 7
0 0 0 0 0 0 0 0 2 0 0 0 0 0 2 0 0 0 0 0 0 0 0 0 0 0 0 0 0 0 C C C C C C C C C C C C C C C C C C C C C C C C C C C C C C C C C C C C C C C C 4 4 4 4 4 4 4 4 4 4 4 6 6 6 6 6 6 6 6 6 4 4 4 4 4 4 4 4 7 7
0 0 0 0 0 0 0 0 0 2 1 1 1 2 0 0 0 0 0 0 0 0 0 0 0 0 0 0 0 0 C C C C C C C C C C C C C C C C C C C C C C C C C C C C C C C C C C C C C C C C 4 4 4 4 4 4 4 4 4 4 4 6 6 6 6 6 6 6 6 6 4 4 4 4 4 4 4 4 7 7
0 0 0 0 3 0 0 0 2 1 1 1 2 0 0 0 3 0 0 0 0 0 0 0 0 0 0 0 0 0 C C C C C C C C C C C C C C C C C C C C C C C C C C C C C C C C C C C C C C C C 4 4 4 4 4 4 4 4 4 4 4 6 6 6 6 6 6 6 6 6 4 4 4 4 4 4 4 4 7 7
0 0 0 0 0 0 0 0 2 1 1 1 2 0 0 0 0 0 0 0 0 0 0 0 0 0 0 0 0 0 C C C C C C C C C C C C C C C C C C C C C C C C C C C C C C C C C C C C C C C C 4 4 4 4 4 4 4 4 4 4 6 6 6 6 6 6 6 6 6 6 6 7 7 7 7 7 7 7 4 4
0 0 0 0 0 0 0 0 2 1 1 1 2 0 0 0 0 0 0 0 0 0 0 0 0 0 0 0 0 0 C C C C C C C C C C C C C C C C C C C C C C C C C C C C C C C C C C C C C C C C 4 4 4 4 4 4 4 4 4 4 4 6 6 6 6 6 6 6 6 6 4 7 7 7 7 7 7 7 4 4
0 0 0 0 0 0 0 2 1 1 1 2 0 0 0 0 0 0 0 0 0 0 0 0 0 0 0 0 0 0 C C C C C C C C C C C C C C C C C C C C C C C C C C C C C C C C C C C C C C C C 4 4 4 4 4 4 4 4 4 4 4 6 6 6 6 6 6 6 6 6 4 7 7 7 7 7 7 7 4 4
0 0 0 0 0 0 0 2 1 1 1 2 0 0 0 0 0 0 0 0 0 0 0 0 0 0 0 0 0 0 C C C C C C C C C C C C C C C C C C C C C C C C C C C C C C C C C C C C C C C C 4 4 4 4 4 4 4 4 4 4 4 6 6 6 6 6 6 6 6 6 4 7 7 7 7 7 7 7 4 4
0 0 0 0 0 0 2 1 1 1 2 0 0 0 0 0 0 0 0 0 0 0 0 0 0 0 0 0 0 0 C C C C C C C C C C C C C C C C C C C C C C C C C C C C C C C C C C C C C C C C 4 4 4 4 4 4 4 4 4 4 4 4 6 6 6 6 6 6 6 4 4 7 7 7 7 7 7 7 4 4
0 0 3 0 0 0 2 1 1 1 2 0 0 0 3 0 0 0 0 0 0 0 0 0 0 0 0 0 0 0 C C C C C C C C C C C C C C C C C C C C C C C C C C C C C C C C C C C C C C C C 4 4 4 4 4 4 4 4 4 4 4 4 4 4 7 6 7 7 7 7 7 4 4 4 4 4 4 4 4 4
0 0 0 0 0 2 1 1 1 2 0 0 0 0 0 0 0 0 0 0 0 0 0 0 0 0 0 0 0 0 C C C C C C C C C C C C C C C C C C C C C C C C C C C C C C C C C C C C C C C C 4 4 4 4 4 4 4 4 4 4 4 4 4 4 7 7 7 7 7 7 7 4 4 4 4 4 4 4 4 4
0 0 0 0 0 2 1 1 1 2 0 0 0 0 0 0 0 0 0 0 0 0 0 0 0 0 0 0 0 0 C C C C C C C C C C C C C C C C C C C C C C C C C C C C C C C C C C C C C C C C 4 4 4 4 4 4 4 4 4 4 4 4 4 4 7 7 7 7 7 7 7 4 4 4 4 4 4 4 4 4
0 0 0 0 0 2 1 1 1 2 0 0 0 0 0 0 0 0 0 0 0 0 0 0 0 0 0 0 0 0 C C C C C C C C C C C C C C C C C C C C C C C C C C C C C C C C C C C C C C C C 4 4 4 4 4 4 4 4 4 4 4 4 4 4 7 7 7 7 7 7 7 4 4 4 4 4 4 4 4 4
0 0 0 0 2 1 1 1 2 0 0 0 0 0 0 0 0 0 0 0 0 0 0 0 0 0 0 0 0 0 C C C C C C C C C C C C C C C C C C C C C C C C C C C C C C C C C C C C C C C C 4 4 4 4 4 4 4 4 4 4 4 4 4 4 7 7 7 7 7 7 7 4 4 4 4 4 4 4 4 4
0 0 0 0 2 1 1 1 2 0 0 0 0 0 0 0 0 0 0 0 0 0 0 0 0 0 0 0 0 0 C C C C C C C C C C C C C C C C C C C C C C C C C C C C C C C C C C C C C C C C 4 4 4 4 4 4 4 7 7 7 7 7 7 7 4 4 4 4 4 4 4 4 4 4 4 4 4 4 4 4
3 0 0 0 2 1 1 1 2 0 0 0 3 0 0 0 0 0 0 0 0 0 0 0 0 0 0 0 0 0 C C C C C C C C C C C C C C C C C C C C C C C C C C C C C C C C C C C C C C C C 4 4 4 4 4 4 4 7 7 7 7 7 7 7 4 4 4 4 4 4 4 4 4 4 4 4 4 4 4 4
0 0 0 0 2 1 1 1 2 0 0 0 0 0 0 0 0 0 0 0 0 0 0 0 0 0 0 0 0 0 C C C C C C C C C C C C C C C C C C C C C C C C C C C C C C C C C C C C C C C C 4 4 4 4 4 4 4 7 7 7 7 7 7 7 4 4 4 4 4 4 4 4 4 4 4 4 4 4 4 4
0 0 0 0 2 1 1 1 2 0 0 0 0 0 0 0 0 0 0 0 0 0 0 0 0 0 0 0 0 0 C C C C C C C C C C C C C C C C C C C C C C C C C C C C C C C C C C C C C C C C 4 4 4 4 4 4 4 7 7 7 7 7 7 7 4 4 4 4 4 4 4 4 4 4 4 4 4 4 4 4
0 0 0 0 2 1 1 1 2 0 0 0 0 0 0 0 0 0 0 0 0 0 0 0 0 0 0 0 0 0 C C C C C C C C C C C C C C C C C C C C C C C C C C C C C C C C C C C C C C C C 4 4 4 4 4 4 4 7 7 7 7 7 7 7 4 4 4 4 4 4 4 4 4 4 4 4 4 4 4 4
R 12 12 1 5
R 34 18 1 4
R 52 22 1 5
R 70 16 1 4
R 88 26 1 5
R 20 38 2 4
R 42 44 2 5
R 58 50 2 4
R 74 56 2 5
R 90 62 2 4
R 24 72 3 4
R 48 78 3 5
R 66 84 3 4
R 82 90 3 5
R 96 96 3 4
