50 50
0 0 0 0 0 0 0 0 3 3 0 0 0 0 0 0 8 8 8 8 8 8 8 8 3 3 8 8 8 8 8 8 8 8 D D D D E E D D D D D D D D D D
0 0 0 0 0 0 0 0 3 3 0 0 0 0 0 0 8 8 8 8 8 8 8 8 3 3 8 8 8 8 8 8 8 8 D D D D E E D D D D D D D D D D
0 0 0 0 0 0 0 0 3 3 0 0 0 0 0 0 8 8 8 8 8 8 8 8 3 3 8 8 8 8 8 8 8 8 D D D D E E D D D D D D D D D D
0 0 A A A A A A 3 3 0 0 0 0 0 0 8 8 8 8 8 8 8 8 3 3 8 8 8 8 8 8 8 8 D D D D E E D D D D D D D D D D
0 0 A 6 6 6 6 A 3 3 0 0 0 0 0 0 3 3 3 3 3 3 3 3 3 3 3 3 3 3 3 3 3 3 D D D D E E D D D D D D D D D D
0 0 A 6 6 6 6 A 3 3 0 0 0 0 0 5 3 3 3 3 3 3 3 3 3 3 3 3 3 3 3 3 3 3 D D D D E E D E E E E E E E E D
0 0 A 6 6 6 6 A 3 3 0 0 0 0 0 5 5 8 A A A A 8 8 3 3 8 8 8 8 8 8 8 8 D D D D E E D E A A A A A A E D
0 0 A 6 6 6 6 A 3 3 0 0 0 0 0 0 8 8 A 9 9 A 8 8 3 3 8 8 8 8 8 8 8 8 D D D D E E D E A D D D D A E D
0 0 A A 3 3 A A 3 3 0 0 0 0 0 0 8 8 A 9 9 A 8 8 3 3 8 8 8 8 8 8 8 8 D D D D E E D E A D D D D A E D
0 0 0 0 3 3 0 0 3 6 6 6 6 6 6 6 8 8 A 3 3 A 8 8 3 3 8 8 8 8 8 8 8 8 D D D D E E D E A D D D D A E D
0 0 0 0 3 3 0 0 3 6 4 4 4 4 4 6 8 8 3 3 3 8 8 8 3 3 8 8 8 8 8 8 8 8 D D D D E E D E A D D D D A E D
0 0 0 0 3 3 0 0 3 6 4 4 4 4 4 6 8 8 3 3 3 8 8 8 3 3 8 8 8 8 8 8 8 8 D D D D E E D E A A 3 3 A A E D
0 0 0 0 3 3 0 0 3 6 4 4 4 4 4 6 8 8 3 3 3 8 8 8 8 8 8 8 8 8 8 8 8 8 D D D D E E D E E E 3 3 E E E D
0 0 0 0 3 3 0 0 3 6 4 4 4 4 4 6 8 8 3 3 3 9 9 9 9 9 9 9 9 8 8 8 8 8 D D D D E E D D D D 3 3 D D D D
0 0 0 0 3 3 0 0 3 6 4 4 4 4 4 6 8 8 3 3 3 9 9 9 9 9 9 9 9 8 8 8 8 8 D D D D E E D D D D 3 3 D D D D
0 0 0 0 5 5 0 0 3 6 6 6 6 6 6 6 8 8 3 3 3 9 9 9 9 9 9 9 9 8 8 8 8 8 D D D D E E D D D D 3 3 D D D D
0 0 0 0 5 5 0 0 3 3 0 0 0 0 0 0 8 8 3 3 3 9 9 9 9 9 9 9 9 8 8 8 8 8 D D D D E E D D D D 3 3 D D D D
0 0 0 0 3 3 0 0 3 3 0 0 0 0 0 0 8 8 3 3 3 9 9 9 9 9 9 9 9 8 8 8 8 8 D D D D E E D D D D 3 3 D D D D
0 0 0 0 3 3 0 0 3 3 0 0 0 0 0 0 8 8 3 3 3 9 9 9 9 9 9 9 9 8 8 8 8 8 D D D D E E D D D D 3 3 D D D D
0 0 0 0 3 3 0 0 3 3 0 0 0 0 0 0 8 8 3 3 3 8 8 8 8 8 8 8 8 8 8 8 8 8 D D D D E E D D D D 3 3 D D D D
0 0 0 0 0 0 3 3 3 3 3 0 0 0 0 0 8 8 3 3 3 8 8 8 3 3 8 8 8 8 8 8 8 8 D D 3 3 F F 3 3 D D 3 3 D D D D
0 0 0 0 0 0 3 3 3 3 3 0 0 0 0 0 8 8 3 3 3 8 8 8 3 3 8 8 8 8 8 8 8 8 D D 3 3 F F 3 3 D D 3 3 D D D D
0 0 0 0 0 0 3 3 3 3 3 0 0 0 0 0 8 8 3 3 3 8 8 8 3 3 8 8 8 8 8 8 8 8 D D 3 3 F F 3 3 D D 3 3 D D D D
0 0 0 0 0 0 3 3 3 3 3 0 0 0 0 0 8 8 3 3 3 8 8 8 3 3 8 8 8 8 8 8 8 8 D D 3 3 F F 3 3 D D 3 3 D D D D
3 3 3 3 3 3 3 3 3 3 3 3 3 3 3 3 3 3 3 3 3 3 3 3 3 3 3 3 3 3 3 3 3 3 3 3 3 3 F F 3 3 3 3 3 3 3 3 3 3
3 3 3 3 3 3 3 3 3 3 3 3 3 3 3 3 3 3 3 3 3 3 3 3 3 3 3 3 3 3 3 3 3 3 3 3 3 3 F F 3 3 3 3 3 3 3 3 3 3
0 0 0 0 0 0 0 3 3 3 3 0 0 0 0 0 8 8 8 8 8 8 8 8 3 3 8 8 8 8 8 8 8 8 D D 3 3 F F 3 3 D D 3 3 D D D D
0 0 0 0 0 0 0 3 3 3 3 0 5 5 0 0 8 8 8 8 8 8 8 8 3 3 8 8 8 8 8 8 8 8 D D 3 3 F F 3 3 D D 3 3 D D D D
0 0 0 0 0 5 5 3 3 3 3 0 5 5 0 0 8 8 5 5 8 8 8 8 3 3 8 8 8 8 8 8 8 8 D D 3 3 F F 3 3 D D 3 3 D D D D
0 0 0 0 0 5 5 3 3 3 3 0 0 0 0 0 8 8 5 5 8 8 8 8 3 3 8 8 8 8 8 8 8 8 D D 3 3 F F 3 3 D D 3 3 D D D D
0 0 0 0 0 0 0 3 3 3 3 0 0 0 0 0 8 8 8 8 8 8 8 8 3 3 8 8 5 5 8 8 8 8 D D 3 3 F F 3 3 D D D D D D D D
0 3 3 3 3 3 3 3 3 3 3 3 3 3 3 0 8 8 8 8 8 8 8 8 3 3 8 8 5 5 8 8 8 8 D D 3 3 F F 3 3 D D D D D D D D
0 3 3 3 3 3 3 3 3 3 3 3 3 3 3 0 8 8 8 8 8 8 3 3 3 3 8 8 8 8 8 8 8 8 3 3 3 3 3 3 3 3 3 3 3 3 3 3 3 3
0 3 3 6 0 6 0 6 0 6 0 6 0 3 3 0 8 8 8 8 8 8 3 3 3 3 8 8 8 8 8 8 8 8 3 3 3 3 3 3 3 3 3 3 3 3 3 3 3 3
0 3 3 0 6 0 6 0 6 0 6 0 6 3 3 0 8 8 8 8 8 8 3 3 3 3 8 8 8 8 8 8 8 8 D D D D E E D D D D D D D D D D
0 3 3 6 0 6 0 6 0 6 0 6 0 3 3 0 8 8 8 8 8 8 3 3 3 3 8 8 8 8 8 8 8 8 D D D D E E D D D D D D D D D D
0 3 3 0 6 0 6 0 6 0 6 0 6 3 3 0 8 8 8 8 8 8 3 3 3 3 8 8 8 8 8 8 8 8 E E D D E E D D E E D D E E D D
0 3 3 3 3 3 3 3 3 3 3 3 3 3 3 0 8 8 8 8 8 8 3 3 3 3 8 8 8 8 8 8 8 8 E D D E E D D E E D D E E D D D
0 3 3 3 3 3 3 3 3 3 3 3 3 3 3 0 8 8 8 8 8 8 3 3 3 3 8 8 8 8 8 8 8 8 D D E E D D E E D D E E D D D D
0 0 0 0 0 0 0 0 3 3 0 0 0 0 0 0 8 8 8 8 8 8 8 8 3 3 8 8 8 8 8 8 8 8 D E E D D E E D D E E D D E D D
0 0 0 0 0 0 0 0 3 3 0 0 0 0 0 0 8 8 8 8 8 8 8 8 3 3 8 8 8 8 8 8 8 8 E E D D E E D D E E D D E E D D
0 0 0 0 0 0 0 0 3 3 0 0 0 0 0 0 8 8 8 8 8 8 8 8 3 3 8 8 8 8 8 8 8 8 E D D E E D D E E D D E E D D D
0 0 0 0 0 0 0 0 3 3 0 0 0 0 0 0 8 8 8 8 8 8 8 8 3 3 8 8 8 8 8 8 8 8 D D E E D D E E D D E E D D D D
0 0 0 0 0 0 0 0 3 3 0 0 0 0 0 0 8 8 8 8 8 8 8 8 3 3 8 8 8 8 8 8 8 8 D E E D D E E D D E E D D E D D
0 0 0 0 0 0 0 0 3 3 0 0 0 0 0 0 8 8 8 8 8 8 8 8 3 3 8 8 8 8 8 8 8 8 E E D D E E D D E E D D E E D D
0 0 0 0 0 0 0 0 3 3 0 0 0 0 0 0 8 8 8 8 8 8 8 8 3 3 8 8 8 8 8 8 8 8 E D D E E D D E E D D E E D D D
0 0 0 0 0 0 0 0 3 3 0 0 0 0 0 0 8 8 8 8 8 8 8 8 3 3 8 8 8 8 8 8 8 8 D D E E D D E E D D E E D D D D
0 0 0 0 0 0 0 0 3 3 0 0 0 0 0 0 8 8 8 8 8 8 8 8 3 3 8 8 8 8 8 8 8 8 D E E D D E E D D E E D D E D D
0 0 0 0 0 0 0 0 3 3 0 0 0 0 0 0 8 8 8 8 8 8 8 8 3 3 8 8 8 8 8 8 8 8 D D D D E E D D D D D D D D D D
0 0 0 0 0 0 0 0 3 3 0 0 0 0 0 0 8 8 8 8 8 8 8 8 3 3 8 8 8 8 8 8 8 8 D D D D E E D D D D D D D D D D
