100 100
2 2 2 2 2 2 2 2 2 2 2 2 2 2 2 2 2 2 2 2 2 2 2 2 2 2 2 2 2 2 2 2 2 2 2 2 2 2 2 2 2 2 2 2 2 2 2 2 2 2 2 2 2 2 2 2 2 2 2 2 2 2 2 2 2 2 2 2 2 2 2 2 2 2 2 2 2 2 2 2 2 2 2 2 2 2 2 2 2 2 2 2 2 2 2 2 2 2 2 2
2 0 3 0 0 3 0 0 2 0 0 2 0 0 0 1 0 0 3 0 0 3 0 0 2 0 0 0 1 0 0 1 0 0 3 0 0 3 0 2 0 1 0 0 1 0 0 1 0 0 3 0 2 0 1 2 0 1 0 0 1 0 0 1 0 2 0 0 2 0 1 2 0 1 0 0 1 0 3 0 0 2 0 0 2 0 1 2 0 1 0 3 0 0 3 0 0 2 0 2
2 2 0 1 0 0 2 1 0 0 2 0 1 0 2 0 1 0 0 2 1 0 0 2 0 1 0 2 0 1 0 0 3 1 0 0 3 0 1 0 3 0 1 0 0 3 1 0 0 3 0 0 0 3 0 0 2 0 1 0 2 0 1 0 0 0 1 0 0 2 0 1 0 2 0 1 0 0 0 1 0 0 2 0 1 0 2 0 1 0 0 0 1 0 0 3 0 1 0 2
2 0 2 0 3 1 0 0 2 3 0 1 0 0 0 2 0 1 1 0 0 2 3 0 1 0 2 0 3 0 1 0 0 0 2 1 0 1 0 2 0 3 0 1 0 2 0 3 1 0 0 0 2 0 1 0 1 0 2 0 3 1 0 0 2 3 0 1 0 0 0 2 0 1 1 0 0 2 3 0 1 0 0 0 3 0 1 0 0 0 2 1 0 1 0 0 0 3 0 2
2 0 0 2 2 0 3 1 0 1 1 0 0 0 2 0 2 3 0 3 1 0 1 0 0 0 0 2 0 2 3 0 1 1 0 1 0 0 0 0 2 0 3 1 0 1 1 0 0 0 2 0 0 3 0 3 1 0 1 0 0 0 0 2 0 0 3 0 1 1 0 1 0 0 0 0 2 0 0 1 0 1 1 0 0 0 2 0 0 3 0 0 1 0 1 0 0 0 0 2
2 0 0 0 0 0 0 0 0 0 0 0 0 2 0 0 2 0 0 2 0 0 2 0 0 2 2 0 2 2 0 2 2 0 0 2 0 0 2 2 0 2 2 0 2 2 0 0 2 0 0 2 3 0 2 3 0 2 3 0 0 3 0 0 3 3 0 3 3 0 3 3 0 0 3 0 0 3 1 0 3 1 0 3 1 0 0 1 0 0 1 1 0 1 1 0 1 1 0 2
2 0 1 1 0 0 1 1 0 0 2 2 0 0 0 0 0 0 0 1 1 0 0 3 3 0 0 2 0 0 0 0 1 1 0 0 3 3 0 0 2 0 0 0 0 1 1 0 0 1 1 0 0 2 0 0 0 0 0 0 0 0 1 1 0 0 3 0 0 2 2 0 0 0 0 1 1 0 0 3 0 0 2 2 0 0 0 0 1 1 0 0 1 0 0 2 2 0 0 2
2 0 1 0 0 2 2 0 0 0 0 3 2 2 0 0 0 0 3 2 0 0 0 0 3 3 2 0 0 0 0 3 3 0 0 0 0 1 3 3 0 0 0 0 1 3 0 0 0 0 1 1 3 0 0 0 0 1 1 0 0 0 0 1 1 1 0 0 0 0 1 1 0 0 2 0 1 1 1 0 0 2 0 1 1 0 0 2 2 0 1 1 0 0 2 2 0 1 0 2
2 0 0 3 2 0 1 1 0 0 0 0 0 0 0 0 3 2 2 1 1 0 0 0 0 0 0 0 0 1 3 2 0 1 0 0 0 0 0 0 2 0 1 3 2 0 1 0 0 0 0 0 0 2 0 1 1 3 0 0 0 0 0 0 0 0 2 2 1 1 3 0 0 0 0 0 0 0 0 3 2 0 1 1 0 0 0 0 0 2 0 0 3 2 0 1 1 0 0 2
2 1 1 2 0 1 3 0 1 3 0 1 1 2 0 1 3 0 1 3 0 1 1 0 0 1 3 0 1 3 0 1 1 0 0 1 0 0 1 3 0 1 1 0 0 1 0 0 1 0 0 1 1 0 0 1 0 0 1 0 0 1 0 0 0 1 0 0 1 0 0 1 0 0 0 0 0 0 1 0 0 1 0 0 0 0 0 0 0 0 0 1 0 0 0 0 0 0 0 2
2 0 0 0 1 0 0 1 2 1 3 0 0 0 0 0 0 1 0 0 1 2 1 3 2 0 0 0 0 0 0 0 0 1 3 0 1 2 0 0 0 0 0 0 0 0 1 3 0 1 2 0 0 2 0 0 0 0 0 0 1 0 1 3 0 0 2 0 0 0 0 0 0 1 0 1 3 2 0 2 0 0 0 0 0 0 1 0 0 1 2 0 3 0 0 0 0 0 0 2
2 1 2 0 0 0 1 0 1 2 0 0 1 3 1 3 0 0 0 1 0 1 2 0 0 0 3 0 3 0 0 0 1 0 1 2 0 0 0 1 0 1 2 0 0 1 0 1 3 0 0 0 1 0 1 2 0 0 0 0 0 3 0 0 0 1 0 1 2 0 0 0 0 0 1 2 0 0 1 0 1 3 0 0 0 0 0 1 2 0 0 0 0 0 3 0 0 0 0 2
2 0 0 1 4 0 0 1 0 0 0 3 0 0 0 0 1 2 0 0 1 2 0 0 2 0 0 0 0 1 2 0 0 1 4 0 0 1 2 0 0 0 0 3 0 0 1 2 0 0 1 2 0 0 0 0 3 0 0 0 3 0 0 1 2 0 2 0 0 2 0 0 0 3 4 0 0 3 0 4 0 0 1 2 0 0 1 0 0 0 3 0 2 0 0 1 2 0 0 2
2 0 0 2 4 0 1 2 0 0 2 0 0 2 0 0 1 0 0 1 2 0 0 2 0 0 1 0 0 1 2 0 0 2 0 0 3 0 0 1 0 0 1 4 0 0 3 0 0 2 0 0 1 4 0 0 2 0 0 2 0 0 1 4 0 1 2 0 0 2 0 0 1 4 0 1 2 0 0 2 0 0 3 0 0 1 0 0 1 4 0 0 3 0 0 1 0 0 1 2
2 1 4 0 1 0 0 2 0 0 3 0 0 0 1 2 0 1 4 0 1 0 0 2 0 0 0 0 4 0 1 2 0 1 4 0 1 4 0 0 0 2 0 0 4 0 1 4 0 1 0 0 0 0 2 0 0 2 0 0 2 0 1 4 0 0 0 2 0 0 3 0 0 2 0 0 2 0 4 0 1 0 0 2 0 0 3 0 0 2 0 0 0 1 4 0 1 0 0 2
2 0 0 4 0 1 0 4 0 2 0 0 4 2 0 0 4 0 1 0 2 0 1 0 0 2 1 0 0 2 0 1 4 2 0 1 4 0 2 1 0 0 2 0 1 0 2 0 1 4 0 2 1 4 0 3 0 0 4 2 0 0 4 0 2 0 4 0 2 0 0 4 2 0 0 2 0 1 0 4 0 1 0 0 2 1 0 0 2 0 1 0 2 0 1 0 0 2 1 2
2 1 0 0 4 2 0 2 0 4 0 4 0 0 1 0 0 4 2 0 1 0 4 0 2 0 0 1 4 0 4 2 0 1 0 4 0 2 0 0 0 4 0 2 2 0 1 4 4 0 2 0 0 0 4 0 2 1 0 0 4 2 0 2 0 4 0 4 0 2 1 0 0 4 2 0 1 0 4 0 2 0 2 1 4 0 4 2 0 1 0 4 0 2 0 1 0 4 0 2
2 0 1 0 0 0 4 4 0 4 2 0 2 1 0 1 0 4 0 4 4 0 2 2 0 2 1 0 1 0 4 0 4 2 0 2 2 0 1 1 0 0 4 4 0 4 2 0 2 1 0 1 0 4 0 4 4 0 2 2 0 2 1 0 1 0 4 0 4 2 0 2 2 0 1 1 0 0 0 4 0 4 2 0 2 1 0 1 0 4 0 0 4 0 2 2 0 2 1 2
2 2 0 0 2 0 0 2 1 0 2 1 0 0 1 0 0 1 0 0 1 1 0 1 1 0 0 1 0 0 1 0 0 1 1 0 1 1 0 0 1 0 0 1 0 0 1 0 0 1 0 0 4 0 0 4 0 0 4 0 0 4 0 0 4 4 0 4 4 0 4 4 0 0 4 0 0 4 4 0 4 4 0 4 4 0 0 4 0 0 4 4 0 4 4 0 4 4 0 2
2 0 2 2 0 0 4 4 0 0 0 0 1 1 0 2 2 0 0 4 4 0 0 4 4 1 1 0 2 2 0 0 2 2 0 0 4 4 0 0 0 1 1 0 0 2 2 0 0 4 4 0 0 0 1 1 0 0 2 2 0 0 4 4 0 0 4 1 1 0 0 2 2 0 0 2 2 0 0 4 0 0 0 0 1 1 0 0 2 2 0 0 4 0 0 0 0 1 1 2
2 2 2 0 0 0 0 2 2 0 0 4 0 0 2 2 0 0 4 0 1 2 0 0 4 4 0 1 2 0 0 4 4 1 1 0 0 4 4 4 1 1 0 0 4 4 1 1 0 0 4 4 4 1 1 0 0 4 4 0 1 0 0 2 4 4 0 1 0 0 2 4 0 0 0 0 2 2 4 0 0 0 0 2 2 0 0 0 0 2 2 2 0 0 0 0 2 2 0 2
2 0 0 4 0 0 2 4 1 1 2 0 0 1 0 0 4 0 0 2 4 0 1 2 0 0 0 0 0 4 4 0 2 2 0 1 1 0 0 0 0 0 4 4 0 2 2 0 0 1 0 0 0 0 0 2 4 4 1 2 0 0 1 0 0 0 0 0 2 4 4 1 2 0 0 0 0 0 0 4 0 2 2 4 1 1 0 0 0 0 0 0 4 0 2 2 4 0 1 2
2 2 4 0 4 4 4 2 2 5 1 2 4 0 4 4 4 2 2 5 1 2 4 1 4 4 4 2 2 5 1 2 4 1 4 4 1 2 2 5 1 2 4 1 4 4 1 2 2 7 1 2 4 1 4 4 1 2 2 7 1 2 0 1 4 4 1 2 2 7 1 2 0 1 4 0 1 2 2 7 1 2 0 1 4 0 1 2 0 7 1 2 0 1 4 0 1 2 0 2
2 0 0 4 4 1 2 4 5 4 4 0 0 7 7 0 1 2 7 4 4 0 2 5 6 0 0 0 7 4 2 0 1 4 5 2 4 0 7 7 0 0 0 4 7 1 2 4 4 5 0 0 0 6 7 0 1 0 4 4 4 1 2 5 6 0 0 0 7 4 0 0 2 5 4 2 4 0 7 5 0 0 1 7 7 1 2 1 4 5 0 0 4 6 7 0 0 0 4 2
2 2 5 7 7 2 4 4 5 6 0 1 4 5 4 4 0 7 4 5 1 4 5 7 7 2 4 4 5 6 0 1 4 4 4 0 0 7 4 5 2 4 6 7 4 2 1 4 5 7 0 1 5 4 5 0 0 7 4 7 2 4 6 7 4 2 1 4 5 7 0 2 7 4 5 0 0 4 4 4 2 4 7 7 4 0 1 5 5 7 0 2 7 4 5 0 0 4 7 2
2 7 4 5 6 0 4 5 6 7 2 5 7 7 7 1 4 5 7 4 4 6 7 4 5 0 7 7 7 4 0 7 4 4 5 0 4 5 6 7 0 7 4 5 7 0 4 5 7 4 2 5 7 6 7 2 5 7 7 4 4 7 7 4 5 0 6 7 4 5 0 7 4 5 7 0 4 5 7 5 0 4 5 6 7 1 5 6 7 4 4 7 5 7 4 2 5 7 4 2
2 7 4 5 7 7 4 6 7 4 5 7 4 5 7 4 5 6 7 4 5 7 4 5 7 4 5 7 7 4 6 7 4 5 7 4 5 7 4 5 6 7 4 5 7 4 5 7 4 5 7 7 4 6 7 4 5 7 4 5 7 4 5 6 7 4 5 7 4 5 7 4 5 7 7 4 6 7 4 5 7 4 5 7 4 5 6 7 4 5 7 4 5 7 4 5 7 7 4 2
2 4 6 7 5 7 4 5 7 4 5 7 4 7 4 6 7 4 6 7 5 7 4 5 7 4 7 4 5 7 4 6 7 4 6 7 5 7 4 7 4 5 7 4 5 7 4 6 7 4 6 7 7 4 5 7 4 5 7 4 5 7 4 6 7 7 4 5 7 4 5 7 4 5 7 4 5 7 7 4 5 7 4 5 7 4 5 7 4 5 7 6 7 5 7 4 5 7 4 2
2 7 4 6 7 5 7 6 7 5 7 4 5 5 7 4 5 7 5 7 5 7 5 7 4 5 5 7 4 5 7 4 7 5 7 4 7 4 5 4 7 4 5 7 4 6 5 7 4 6 4 5 4 6 4 5 7 4 6 5 7 4 6 7 5 4 6 7 5 7 4 5 5 7 4 5 7 5 4 5 7 5 7 4 5 5 7 4 5 7 4 4 5 7 4 7 4 5 4 2
2 5 7 4 6 5 7 5 7 7 4 5 7 7 4 7 4 6 5 7 5 7 6 4 5 7 7 4 7 4 5 5 7 4 7 6 4 5 7 7 4 6 4 5 5 7 4 7 5 7 5 7 7 4 6 4 5 5 7 4 6 5 7 5 7 7 4 5 7 5 4 7 4 6 5 7 5 7 6 4 5 7 5 4 7 4 5 5 7 4 7 6 4 5 7 5 4 6 4 2
2 7 5 7 7 4 7 6 4 5 5 7 5 5 7 4 7 7 4 6 5 4 5 5 7 5 4 7 4 7 6 4 6 5 7 5 5 7 5 4 7 4 7 6 4 5 5 7 5 5 7 4 4 7 4 6 5 4 5 5 7 5 4 7 4 4 6 4 6 5 7 5 5 7 5 4 7 4 4 6 4 5 5 7 5 5 7 4 4 7 4 4 5 4 5 5 7 5 4 2
2 5 7 7 5 7 7 5 5 7 5 5 7 7 5 7 7 5 7 7 5 4 7 5 4 7 7 4 7 7 4 7 7 4 4 7 4 4 7 7 4 7 7 4 7 7 4 4 7 4 4 7 7 4 7 7 4 7 7 4 4 7 4 4 7 6 4 7 6 4 7 6 4 4 6 4 4 6 6 4 6 6 4 6 6 4 4 6 4 4 6 5 4 6 5 4 6 5 4 2
2 7 5 5 4 4 6 6 4 4 7 7 4 4 7 5 5 7 7 5 5 4 4 7 7 4 4 7 5 5 7 7 5 5 4 4 6 6 4 4 7 5 5 7 7 5 5 4 4 6 6 4 4 7 4 4 7 7 5 5 7 7 5 5 4 4 7 4 4 7 7 5 5 7 7 5 5 4 4 6 4 4 7 7 5 5 7 7 5 5 4 4 6 4 4 7 7 4 4 2
2 5 5 4 4 7 7 5 5 4 4 7 7 7 5 5 4 4 7 7 5 5 7 4 6 7 7 5 5 7 4 6 7 4 5 7 7 6 6 7 4 5 7 7 6 6 4 4 7 7 5 6 6 4 4 7 7 5 6 4 4 7 7 5 5 6 4 4 7 7 5 5 4 4 7 7 5 5 5 4 4 7 7 5 5 4 4 7 7 5 5 5 4 4 7 7 5 5 4 2
2 7 4 7 7 7 5 6 4 5 5 4 4 4 7 7 6 7 7 5 5 4 4 5 4 4 4 7 7 6 7 7 5 5 4 4 5 7 4 4 7 7 5 6 7 5 5 4 4 4 7 4 4 7 7 5 6 7 5 5 4 4 4 7 7 4 7 7 5 5 6 4 5 4 4 4 7 7 4 7 7 5 5 6 4 5 7 4 4 7 7 7 6 7 5 5 5 4 4 2
2 5 6 7 5 5 7 5 5 6 5 5 6 7 5 5 7 5 5 6 5 5 6 4 5 5 7 5 5 6 5 5 6 4 5 5 4 5 5 6 5 5 6 4 5 5 4 5 5 4 5 5 6 4 5 5 4 5 5 4 5 5 4 4 5 5 4 5 5 4 5 5 4 4 5 4 4 5 5 4 5 5 4 4 5 4 4 5 4 4 5 5 4 4 5 4 4 5 4 2
2 7 4 5 5 4 5 6 7 5 7 7 4 4 7 4 4 5 4 5 5 7 5 6 7 7 4 7 4 4 5 4 5 5 6 5 6 7 7 4 7 4 4 5 4 4 5 6 5 6 7 7 4 7 7 4 5 4 4 5 6 5 5 7 7 4 7 7 4 5 4 4 5 5 5 5 6 7 7 7 7 4 4 7 4 5 5 4 5 6 7 7 7 7 4 4 7 4 4 2
2 5 7 7 4 5 6 5 6 7 4 4 5 6 5 7 7 4 5 6 5 5 7 7 4 5 6 5 6 7 4 4 5 5 5 7 7 4 5 6 5 6 7 4 4 5 4 5 6 7 4 5 5 5 6 7 7 4 5 4 5 6 7 4 5 5 4 5 7 7 4 5 4 5 6 7 4 4 5 4 5 7 7 4 5 4 5 5 7 7 4 5 4 5 6 7 4 4 4 2
2 4 5 6 7 4 5 6 7 4 5 6 7 4 7 4 5 7 4 5 5 7 4 5 6 7 4 7 4 5 7 7 4 5 7 4 4 6 7 4 7 4 5 6 7 4 5 7 7 4 5 7 4 7 4 5 6 7 4 5 7 7 4 5 7 7 7 4 5 6 7 4 5 6 7 4 5 6 7 7 4 4 6 7 4 5 6 7 4 5 6 7 7 7 4 5 7 4 5 2
2 7 5 6 7 4 5 7 4 5 7 4 5 6 7 4 6 7 4 5 7 4 5 6 7 4 6 7 4 5 7 4 5 7 4 5 6 7 4 6 7 4 5 7 4 5 6 7 5 6 7 4 5 7 4 5 7 4 5 6 7 4 6 7 4 5 7 4 5 6 7 5 6 7 4 5 7 4 5 7 4 5 6 7 4 5 7 4 5 7 4 5 6 7 5 6 7 4 5 2
2 5 7 4 6 7 4 6 7 5 6 7 5 4 5 7 4 5 7 4 6 7 4 6 7 5 4 5 7 4 5 7 4 5 7 4 6 7 4 4 5 7 4 5 7 4 5 7 4 5 7 4 7 5 6 4 5 7 4 5 7 4 5 7 4 7 5 6 7 5 6 4 5 7 4 5 7 4 7 4 6 7 5 6 7 5 6 4 5 7 4 7 4 6 7 4 6 7 5 2
2 4 5 7 4 6 7 7 4 6 7 5 7 6 7 5 7 4 6 7 7 4 6 7 5 7 6 7 5 7 4 5 7 7 4 5 7 5 6 5 7 5 6 4 5 7 6 4 5 7 4 6 5 7 4 6 4 5 7 6 4 5 7 4 6 5 7 4 6 7 5 7 6 7 5 7 4 6 5 7 4 6 7 5 7 6 7 5 7 4 5 5 7 4 5 7 5 6 5 2
2 6 7 5 7 7 4 6 4 7 5 7 4 4 5 7 5 7 6 4 6 7 7 5 7 4 4 5 7 5 7 6 4 5 7 7 4 6 4 7 5 7 5 7 6 4 5 7 7 4 6 4 7 5 7 4 6 6 7 5 7 7 4 6 4 7 5 7 4 6 5 7 5 7 6 4 6 7 7 5 7 4 6 5 7 5 7 6 4 5 7 7 4 6 4 6 5 7 5 2
2 4 6 4 7 5 7 7 5 7 6 4 6 6 4 5 7 7 5 7 7 4 7 6 4 6 5 7 5 7 7 5 7 7 4 6 6 4 6 5 7 5 7 7 5 7 6 4 6 6 4 5 5 7 5 7 7 4 7 6 4 6 5 7 5 5 7 5 7 7 4 6 6 4 6 5 7 5 5 7 5 7 6 4 6 6 4 5 5 7 5 5 7 4 7 6 4 6 5 2
2 6 4 4 6 4 4 6 6 4 6 6 4 4 6 4 4 6 4 4 6 5 4 6 5 4 7 5 4 7 5 4 7 5 5 7 5 5 7 7 5 7 7 5 7 7 5 5 7 5 5 7 7 5 7 7 5 7 7 5 5 7 5 5 7 7 5 7 7 5 7 7 5 5 7 5 5 7 7 5 7 7 5 7 7 5 5 7 5 5 7 7 5 7 7 5 7 7 5 2
2 4 6 6 4 4 7 7 5 5 7 7 5 5 4 6 6 4 4 7 7 5 5 7 7 5 5 4 6 6 4 4 7 7 5 5 7 7 5 5 7 6 6 4 4 6 6 4 4 7 7 5 5 7 5 5 4 4 6 6 4 4 7 7 5 5 7 5 5 4 4 6 6 4 4 7 7 5 5 7 5 5 7 7 6 6 4 4 6 6 4 4 7 5 5 7 7 5 5 2
2 6 6 5 5 7 7 6 6 4 5 7 7 7 6 6 4 5 7 7 6 6 4 4 7 7 7 6 6 4 4 7 7 5 6 4 4 7 7 7 5 6 4 4 7 7 5 5 4 4 7 7 7 5 5 4 4 7 7 5 5 4 4 7 7 7 5 5 4 4 7 7 5 5 4 4 6 7 7 5 5 4 4 6 7 5 5 7 4 6 6 7 5 5 7 4 6 6 5 2
2 4 4 7 7 4 7 7 5 6 6 5 5 5 4 4 7 7 4 6 7 5 5 6 4 5 5 4 4 7 7 7 6 7 5 5 6 4 5 5 4 4 7 7 7 6 6 5 5 5 4 4 5 7 4 7 7 7 6 6 5 5 5 4 4 5 7 4 6 7 7 5 6 4 5 5 4 4 4 7 7 6 7 7 5 6 4 5 5 4 4 4 7 7 6 6 7 5 5 2
2 6 7 7 6 7 7 6 7 7 6 6 7 7 6 7 7 6 7 7 6 6 7 5 6 7 7 6 7 7 6 6 7 5 6 7 5 6 7 7 6 6 7 5 6 7 5 6 7 5 6 6 7 5 6 7 5 6 7 5 6 6 5 5 6 7 5 6 7 5 6 6 5 5 6 5 5 6 7 5 6 6 5 5 6 5 5 6 5 5 6 6 5 5 6 5 5 6 5 2
2 4 5 6 7 5 6 7 7 7 7 4 4 5 4 5 5 6 5 6 7 7 6 7 4 4 5 4 5 5 6 5 6 7 7 6 7 7 4 5 4 4 5 6 5 5 6 7 6 7 7 4 5 4 4 5 6 5 5 6 7 6 7 7 4 4 7 4 5 5 4 5 6 7 5 6 7 4 4 7 4 5 5 4 5 6 7 5 6 7 7 4 7 4 4 5 4 5 5 2
2 7 7 4 5 6 7 6 7 4 4 5 6 7 8 7 4 5 6 9 6 7 7 4 6 6 7 6 7 4 5 5 7 5 8 7 4 5 6 9 6 7 4 4 6 6 5 6 7 4 5 6 7 6 9 7 4 5 6 6 6 7 4 5 6 7 5 7 7 4 5 6 5 6 9 4 4 5 6 6 6 7 4 5 6 5 6 7 7 4 5 6 5 6 9 4 5 5 5 2
2 4 5 9 4 5 6 7 4 5 6 7 4 5 4 5 7 7 5 6 7 4 5 6 9 4 5 4 6 8 7 4 5 8 9 4 5 7 4 5 4 5 6 9 4 5 6 7 4 6 7 7 4 4 5 6 7 4 5 8 7 4 5 8 9 4 4 5 6 9 4 5 6 9 4 5 6 7 4 9 4 5 7 4 5 6 7 4 5 8 7 4 7 4 6 7 7 4 6 2
2 4 6 9 4 5 7 4 5 8 7 4 6 9 4 5 7 4 5 8 7 5 8 9 4 5 7 4 6 8 4 5 8 9 5 6 7 4 6 9 4 5 8 9 5 6 7 4 6 9 4 5 8 4 5 6 7 5 6 9 4 5 9 4 5 6 7 5 8 9 4 5 9 4 6 7 4 5 8 9 4 6 9 4 6 7 4 5 8 9 5 6 9 4 6 7 4 6 8 2
2 8 4 6 9 4 6 9 4 6 7 4 6 5 8 4 5 8 4 6 7 4 6 9 4 5 5 8 9 5 6 4 5 8 4 5 9 4 6 5 6 9 5 8 9 5 8 4 5 8 4 6 4 6 9 4 8 9 5 8 7 5 8 4 5 4 6 9 4 6 7 5 8 9 5 6 9 5 4 6 7 4 6 9 4 6 9 5 8 9 5 4 6 9 4 5 9 4 6 2
2 5 8 4 6 9 4 4 6 9 4 8 9 9 4 8 9 5 9 4 9 5 9 4 6 9 9 4 6 9 5 8 4 9 5 8 4 6 9 8 4 6 9 5 8 4 9 5 8 4 6 9 8 4 6 9 5 8 4 9 5 8 4 6 9 8 4 6 9 4 8 9 9 4 8 9 5 9 8 9 5 9 4 6 9 9 4 6 9 5 8 6 9 5 8 4 6 9 8 2
2 9 4 8 4 9 5 9 5 4 6 9 6 5 8 4 8 4 9 5 9 4 4 6 9 5 5 8 4 6 9 9 5 8 4 4 6 9 5 4 8 4 6 9 9 5 8 4 9 6 9 5 4 8 4 6 9 9 4 8 4 9 5 9 5 4 6 9 6 9 8 4 8 4 9 5 9 4 4 6 9 5 9 8 4 6 9 9 5 8 4 4 6 9 5 9 8 4 6 2
2 5 9 5 4 8 4 4 6 9 9 5 9 9 5 8 4 4 8 4 9 6 9 9 5 9 8 4 8 4 4 6 4 9 6 9 9 5 9 8 4 8 4 4 6 9 9 5 9 9 5 8 8 4 8 4 9 6 9 9 5 9 8 4 8 8 4 6 4 9 6 9 9 5 9 8 4 8 6 4 6 9 9 5 9 9 5 8 8 4 8 6 9 6 9 9 5 9 8 2
2 9 5 5 9 5 5 9 9 5 9 9 5 5 9 5 5 9 5 5 9 8 5 9 8 5 4 8 5 4 8 5 4 8 8 4 8 8 4 4 8 4 4 8 4 4 8 8 4 8 8 4 4 8 4 4 8 4 4 8 8 4 8 8 4 4 8 4 4 8 4 4 8 6 4 8 6 4 4 6 4 4 6 4 4 6 6 4 6 6 4 9 6 4 9 6 4 9 6 2
2 5 9 9 6 6 4 4 8 8 4 4 8 8 5 9 9 6 6 9 9 6 6 4 4 8 8 5 9 9 5 5 9 9 6 6 4 4 8 8 4 9 9 5 5 9 9 6 6 4 4 8 8 4 8 8 5 5 9 9 6 6 9 9 6 6 4 8 8 5 5 9 9 5 5 9 9 6 6 4 8 8 4 4 9 9 5 5 9 9 6 6 4 8 8 4 4 8 8 2
2 9 9 6 6 4 4 9 9 6 6 4 4 4 9 9 6 6 4 4 9 9 6 6 4 4 4 9 9 6 6 4 4 8 9 5 6 4 4 4 8 9 5 6 4 4 8 8 5 5 9 4 4 8 8 5 5 9 4 8 8 5 5 9 9 4 8 8 5 5 9 9 8 8 5 5 9 9 9 8 8 5 5 9 9 6 8 4 5 9 9 9 6 8 4 5 9 9 6 2
2 5 6 4 4 5 9 4 8 9 9 6 8 8 5 6 4 4 5 9 9 8 8 9 6 6 8 5 5 4 4 4 9 9 8 8 9 6 6 8 5 5 9 4 4 9 9 6 8 8 5 6 6 4 5 9 4 4 9 9 6 8 8 5 6 6 4 5 9 9 4 8 9 6 6 8 5 5 6 4 4 9 9 4 8 9 6 6 8 5 5 6 4 4 9 9 9 8 8 2
2 9 4 4 9 9 4 9 9 4 9 9 4 4 9 9 4 9 9 4 9 9 4 8 9 9 4 9 9 4 9 9 4 8 9 9 8 9 9 4 9 9 4 8 9 9 8 9 9 8 9 9 4 8 9 9 8 9 9 8 9 9 8 8 9 9 8 9 9 8 9 9 8 8 9 6 8 9 9 8 9 9 8 8 9 6 8 9 6 8 9 9 8 8 9 6 8 9 6 2
2 6 8 9 B 8 9 4 4 B 4 5 6 8 9 6 8 9 8 B 9 4 9 4 8 6 8 5 6 B 9 8 9 9 8 9 4 4 5 A 5 6 8 9 A 8 9 4 9 B 4 5 6 5 9 8 9 6 8 B 4 9 9 4 9 6 4 5 6 B 6 8 9 9 B 9 4 5 6 8 5 6 8 6 A 9 9 8 9 8 4 5 4 5 9 8 5 6 8 2
2 9 4 9 A 9 4 9 8 8 6 8 9 8 B 4 5 6 B B 9 9 4 9 A 9 4 9 8 9 6 8 9 B B 4 5 8 B 8 9 4 5 9 B 9 8 9 8 9 6 9 9 B B 4 6 8 B A 9 4 5 9 B 9 8 9 8 9 8 9 8 B 8 5 6 8 B B 9 4 5 A B 6 9 9 8 9 8 9 8 B 8 5 6 8 9 2
2 6 B B 8 6 9 8 9 A 9 4 9 A 9 8 9 8 9 B 9 5 9 B 8 5 6 9 A B 4 6 B B 8 6 8 B 8 9 5 8 B 8 9 8 9 8 9 B 9 4 9 9 A 9 4 9 A B 4 5 A B 8 6 5 9 B 8 5 6 B 8 9 8 9 8 9 8 6 8 B 8 9 9 4 9 A B 4 5 8 9 B 9 4 9 B 2
2 9 B 8 9 8 B 8 A B 4 9 B 8 9 8 B 9 A B 4 9 B 8 9 8 8 9 A B 5 A B 8 9 9 8 9 B B 5 A B 8 9 9 8 9 B 8 5 A B 8 A 9 8 9 B 8 5 B B 9 A 9 8 9 B 8 6 B 8 9 A 9 8 A B 8 6 B 8 9 B 9 9 A B 8 6 B 8 9 B 4 9 A B 2
2 B 9 A B 9 B 8 9 B 8 9 B A B 8 A B 9 A B 9 B 8 9 B 9 B 8 A B 8 A B 9 A B 9 B 9 B 8 9 B 8 A B 8 A B 9 A 9 B 8 9 B 8 9 B 8 A B 8 A 9 B 8 9 B 8 9 B 8 9 B 8 A 9 B 8 9 B 8 9 B 8 9 B 8 9 9 A B 9 B 8 9 B 2
2 9 B 8 A 8 9 8 A 8 9 B 8 8 9 B 8 A B 9 8 A B 9 B 8 B 9 B 8 A B 9 8 A B 9 B 8 B 9 B 8 9 B 9 8 9 B 9 B 8 B 9 B 8 9 B 8 8 9 B 8 A 8 B 8 A 8 9 B 8 8 9 B 8 A B B 8 A B 9 B 8 B 9 B 8 A B B 8 A B 9 B 8 B 2
2 B 9 B 9 8 A 8 9 9 B 8 A 9 B 9 B 8 8 A B 9 9 B 8 A 9 B 9 B 8 8 9 B 9 8 B 8 A 9 B 9 B 8 8 9 B 9 8 A 8 9 9 B 8 B 8 B 9 B 9 8 A 8 9 9 B 8 A 8 B 9 B 8 8 A B 9 9 B 8 A 8 B 9 B 8 8 9 B 9 8 B 8 A B B 9 B 2
2 9 B 9 9 B 9 8 B 8 8 A 8 B 9 B 9 9 B 9 8 B 8 8 A 8 B 9 B 9 9 B 8 8 A 8 8 9 B B 9 B 9 8 B 8 8 A 8 B 9 B B 9 B 9 8 B 8 8 A 8 B 9 B B 9 B 8 8 A 8 8 9 B B 9 B B 8 B 8 8 A 8 B 9 B B 9 B B 8 B 8 8 A 8 B 2
2 8 A 9 8 A 9 8 B 9 8 B 9 9 B 9 9 B 9 9 B B 9 B B 9 9 B 9 9 B 9 9 B B 9 B B 9 9 B 9 9 B 9 9 B B 9 B B 9 9 B 9 9 B 9 9 B B 9 B B 9 9 B 9 9 B 9 9 B B 9 B B 9 8 B 9 8 B 9 8 B B 8 B B 8 8 B 8 8 B 8 8 B 2
2 A 8 8 B B 8 8 B B 9 9 B B 9 8 8 A A 8 8 B B 9 9 B B 9 8 8 A A 8 8 B B 9 9 B B 9 B B A A 8 8 B B 8 8 B B 9 B B 9 9 8 8 A A 8 8 B B 9 B B 9 9 8 8 A A 8 8 B B 9 B B 9 9 B B A A 8 8 B B 8 B B 9 9 B B 2
2 8 8 B B 9 9 8 8 B B 9 9 9 8 8 B B 9 9 B 8 A B 9 9 9 B 8 A B 9 9 B B A A 8 9 9 B B A A 8 9 B B A A 8 8 9 B B A A 8 8 B B 9 A 8 8 8 B B 9 A 8 8 B B 9 9 8 8 8 B B 9 9 8 8 B B 9 9 8 8 8 B B 9 9 8 8 B 2
2 A B 9 9 9 8 8 B B 8 B B B A A 9 9 9 8 8 B B 8 B B B 9 A 8 9 9 8 8 B B B A B B 9 A 8 9 9 8 8 B B B A B B 9 9 8 8 9 B 8 B B B A A B 9 9 8 8 9 B 8 B B B 9 A B 9 9 8 8 8 B B A B B 9 A A 9 9 8 8 8 B B 2
2 8 8 9 8 8 9 8 8 9 B 8 8 9 8 8 9 8 8 9 B 8 8 B 8 8 9 8 8 9 B 8 8 B 8 8 B 8 8 9 B 8 8 B 8 8 B 8 8 B B 8 8 B 8 8 B 8 8 B B 8 B B 8 8 B 8 8 B B 8 B B 8 B B 8 8 B B 8 B B 8 B B 8 B B B 8 B B 8 B B 8 B 2
2 A B B 8 B 8 8 9 8 9 9 B B A B B 8 B 8 8 9 8 9 9 A B A B B 8 B B 8 9 8 8 9 A B 9 B B 8 B B 8 9 8 8 9 A B 9 A B B B B 8 8 B 8 9 9 B 9 A B B B B 8 8 B 8 9 9 A 9 A B B A B B 8 B 8 8 9 A 9 9 B B A B B 2
2 8 9 A E 8 8 8 8 A B B 8 9 8 9 A B B 8 B 8 9 A E 8 9 8 9 A B B 8 B 8 9 A B 8 9 8 8 9 B E 8 B 8 9 C B B 8 B 8 9 A B 8 E 8 9 9 B E 8 B 8 9 C B 8 B 8 9 9 B B 8 E 8 9 A B E B B 8 9 C B 8 B 8 9 9 B B B 2
2 B B 8 A B B 8 A E 8 9 A E C B 8 9 C E 8 9 B E 9 9 B A E 8 9 A B 8 A B B 8 A E A B 8 9 C B 8 9 C E 8 9 B A E 8 9 A E 8 9 A B 8 9 A 9 B E 9 9 B 8 9 C B 8 9 C A B B 8 A E B 8 9 E 8 9 A 9 C E 8 9 B E 2
2 A E 9 C B 8 A E 8 9 B E 9 C B 8 A E 8 9 B 8 9 C B 8 C E 8 9 B 8 9 C B 9 C E 8 9 B 8 A E 8 9 C E 9 A B 8 A E 8 9 C E 9 A B 8 A E 8 9 E 8 9 A B 9 C E 8 9 E 8 9 B B 9 C E 8 9 E 8 A B 8 9 C E 8 A E 8 2
2 8 A E 8 A E 9 C E 9 C E E 8 9 E 8 A E 8 C E 9 C B E 8 A E 8 A E 8 A B 8 C E C 8 9 E 8 A B 8 A E 8 9 E C E 9 B 8 9 E 8 9 E 8 A E A E 9 C E 9 C 8 9 E 8 A E C E 8 C E 9 C B 9 C 8 9 B A E 8 C B 9 C E 2
2 C 8 A E 9 C A E 9 C 8 A 9 C 8 A E 8 C A E 8 C E 9 8 C E 9 E 8 C 9 E 8 C E 9 8 C E 9 E 8 A 9 E 8 A E 9 8 A E 9 C 8 A 9 C 8 A E 9 8 A E 9 C 8 A 9 C 8 A E 8 8 A E 8 C E 9 8 C E 9 E 8 E 9 E 8 C E 9 8 2
2 8 C 8 A 9 E 9 C C E A E E 8 C 8 A 9 E 8 C A E 9 E C 8 C E A 9 E 8 C A E 9 E C 8 A E 9 9 C 8 C A E 9 E C 8 A E 9 8 C 8 A 9 E 9 C C E A E 9 8 C 8 A 9 E 8 C A E 9 E 9 8 C E A 9 E 8 C A E 9 E 8 8 A E 2
2 E 8 C C 8 C A E A 9 E 9 8 C 8 C C 8 A A E 9 9 E 9 8 C 8 C A E A 9 E 9 9 E 8 8 C 8 C A E A 9 E 9 8 C 8 8 C 8 A A E 9 9 E 9 8 C 8 8 A E A 9 E 9 9 E 8 8 C 8 E A E A 9 E 9 8 C 8 8 C 8 E A E 9 9 E 9 8 2
2 9 E E 9 E E 9 8 E 9 8 E C 8 E C 8 E C 8 8 C 8 8 C C 8 C C 8 C C 8 8 C 8 8 C C 8 C C 8 C C 8 8 C 8 8 C C 8 C C 8 C C 8 8 C 8 8 C A 8 C A 8 C A 8 E A 8 E A A E A A E A A E E A E E A A E A A E A A E 2
2 E 9 9 E E A A 8 8 C C 8 8 E 9 9 E E A A E E C C 8 8 C 9 9 E E 9 9 E E A A 8 8 C 8 8 E E 9 9 E E A A 8 8 C 8 8 E E 9 9 E E A A E E C 8 8 C C 9 9 E E 9 9 E E A 8 8 C C 8 8 E E 9 9 E E A 8 8 C C 8 8 2
2 9 9 E E C C 9 9 E E C C C 9 9 E E C C 8 9 E E A C C 8 9 E E A C 8 8 E E A A C 8 8 E E A A 8 8 E E A A A 8 8 E E A A 8 8 E E 9 A A 8 8 E E 9 A 8 8 C E 9 9 A 8 8 C E 9 9 E 8 C C 9 9 9 E 8 C C 9 9 E 2
2 E E C C E 9 A 8 8 9 E 8 8 E E A C C 9 A 8 8 9 E E 8 E E A C C 9 9 8 8 8 E E 8 C E A A C 9 9 E 8 8 E E E C E 9 A C 8 9 E 8 8 E E E C C 9 A A 8 9 E E 8 E E E C C 9 9 A 8 8 E E 8 C E E A C 9 9 A 8 8 2
2 9 A C 9 A C 9 9 A 8 9 A C 9 A C 9 9 A 8 9 A 8 9 A C 9 9 A 8 9 A 8 9 A 8 9 9 A 8 9 A 8 9 A 8 9 9 8 8 9 A 8 9 A 8 9 9 8 8 9 8 8 9 A 8 9 9 8 8 9 8 8 9 E 8 9 9 8 8 9 8 8 9 E 8 9 E 8 8 9 8 8 9 E 8 9 E 2
2 E 8 8 E 8 9 A C E C E E 8 C E 8 9 8 C A C 9 A C E 8 E E C 9 8 8 9 C 9 A C E C E E 8 9 C 8 9 A 9 D C E E C C 8 8 E 8 E A 8 9 C C E C E E C E 8 9 A C 9 A C E C E E 8 E C 8 9 8 9 D C E C E C 8 E E 8 2
2 9 C C C 9 A 9 D C E 8 9 C E C E E C D 8 A C C C 9 A 9 C C E 8 9 C E C E 8 C D 9 A C C C 9 8 9 C C E 8 A C D C E 8 E C 9 A E C C 9 8 9 C C 8 9 8 C D C E 8 E C 9 C E C C E 8 A C C 8 9 8 E C E E 8 C 2
2 E C D C E 8 D C C 9 A C C C 8 9 C C C A C C C D E E C C E C E C E C E 8 D C C E 8 E C C 8 9 C C C 9 C C C C 9 A C C E C E C E C E C C C D E E C C C 8 9 C C C E 8 D C C 8 A C C C A E C C C 9 C C C 2
2 C C D C 8 E C C E C C C C C 8 D C C E C C C C C 8 D C C E C C E C C 8 C C C D E C E C C 9 C C C D E C E C C 9 C C C C E C D C C 9 C C C C E C D C C 9 C C E C E C C C C A C C E C E C C C C A C C E 2
2 E C C D C C D C C C C C C E C C E C C D C C D C C C E C C E C C E C C D C C C C C C E C C E C C E C C C C C C C C C E C C E C C C C C C C C C C C C E C C C C D C C C C C C C C C C C C D C C D C C 2
2 C E C C D C C C D C C C D C C C C D C C C D C C C D C C C C E C C C E C C C E C C C C E C C C E C C C E C C C C E C C C E C C D E C C D C C C D C C C C D C C C D C C C D C C C C E C C C E C C C E 2
2 D C E C C C D C C C C C C E C C C C C D C C C C C C E C C C C C E C C C C C C E C C C D C E C C C C C C C C C C D C E C C C D C C C C C C E C C C C C D C C C C C D E C C C C C E C C C C C D E C C 2
2 C D C C E C C C C C C C D C E C C C C C C C C C D E C E C C C C C C C D C D E C E C C C C C C C D C E E C C C C C C C C D E C E C C C C C C C D C D E C E C C C C C C C D C E E C C C C C C C C D E 2
2 D C C D C C D D C D D C C D C C D C C D E C D E C C E C C E C C E E C E E C C E C C E C C E E C E E C C E C C E C C E C C E C C C C C C C C C C C C C C C C C C C C C C C C C C C C C C C C C C C C 2
2 C C C C C C C C C C C E E C C C C C C C C C C C E E C D D C C C C C C C C E E C D D C C C C C C C C C C C E E C C C C C C C C C C C E E C C D D C C C C C C C E E C C D D C C C C C C C C C C C E E 2
2 C C C C C C D C C C C C C D C C C C C D D C C C C C D D C C C C E D C C C C C E D C C C C E E C C C C C E E C C C C E E C C C C C E E C C C C C E C C C C C C E C C C C C C C C C C C C C C C C C C 2
2 2 2 2 2 2 2 2 2 2 2 2 2 2 2 2 2 2 2 2 2 2 2 2 2 2 2 2 2 2 2 2 2 2 2 2 2 2 2 2 2 2 2 2 2 2 2 2 2 2 2 2 2 2 2 2 2 2 2 2 2 2 2 2 2 2 2 2 2 2 2 2 2 2 2 2 2 2 2 2 2 2 2 2 2 2 2 2 2 2 2 2 2 2 2 2 2 2 2 2

R 12 10 1 1
R 25 8 1 1
R 40 18 1 1
R 55 15 1 1
R 70 20 1 1
R 22 32 2 1
R 37 40 2 1
R 48 45 2 1
R 60 38 2 1
R 75 34 2 1
R 30 70 3 1
R 45 78 3 1
R 58 82 3 1
R 72 88 3 1
R 85 76 3 1
