100 100
3 3 3 3 3 3 3 3 3 3 3 3 3 3 3 3 3 3 3 3 3 3 3 3 3 3 3 3 3 3 3 3 3 3 3 3 3 3 3 3 3 3 3 3 3 3 3 3 3 3 3 3 3 3 3 3 3 3 3 3 3 3 3 3 3 3 3 3 3 3 3 3 3 3 3 3 3 3 3 3 3 3 3 3 3 3 3 3 3 3 3 3 3 3 3 3 3 3 3 3
3 2 2 2 4 4 4 4 4 4 4 4 4 4 4 4 4 4 4 4 5 5 5 5 4 4 5 5 5 5 5 5 5 5 5 5 5 5 5 5 5 5 5 5 5 5 5 5 5 5 5 5 5 5 5 5 5 5 5 5 5 5 5 5 5 5 5 5 5 5 5 5 5 5 5 5 5 5 5 5 5 5 5 5 5 5 4 4 4 4 4 4 4 4 4 4 4 4 4 3
3 2 2 2 2 4 4 4 4 4 4 4 4 4 4 4 4 4 4 4 5 5 5 5 4 4 5 5 7 7 7 7 7 7 7 5 5 5 5 5 5 5 5 5 5 5 5 5 5 5 5 5 5 5 5 5 5 5 5 5 5 5 5 5 5 5 5 5 5 5 5 5 5 5 5 5 5 5 5 5 5 5 5 5 5 5 4 4 4 4 4 4 4 4 4 4 4 4 4 3
3 2 2 2 2 2 4 4 4 4 4 4 4 4 4 4 4 4 4 4 5 5 5 5 4 4 5 5 7 7 7 7 7 7 7 5 5 5 5 5 5 5 5 5 5 5 5 5 5 5 5 5 5 5 5 5 5 5 5 5 5 5 5 5 5 5 5 5 5 5 5 5 5 5 5 5 5 5 5 5 5 5 5 5 5 5 4 4 4 4 4 4 4 4 4 4 4 4 4 3
3 2 2 2 2 2 2 4 4 4 4 4 4 4 4 4 4 4 4 4 5 5 5 5 4 4 5 5 7 7 7 7 7 7 7 5 5 5 5 5 5 5 5 5 5 5 5 5 5 5 5 5 5 5 5 5 5 5 5 5 5 5 5 5 5 5 5 5 5 5 5 5 6 6 6 6 6 6 6 6 5 5 5 5 5 5 4 4 4 4 4 4 4 4 4 4 4 4 4 3
3 2 2 2 2 2 2 2 4 4 4 4 4 4 4 4 4 4 4 4 5 5 5 5 4 4 5 5 5 5 5 5 5 5 5 5 5 5 5 5 5 5 5 5 5 5 5 5 5 5 5 5 5 5 5 5 5 5 5 5 5 5 5 5 5 5 5 5 5 5 5 5 6 6 6 6 6 6 6 6 5 5 5 5 5 5 4 4 4 4 4 4 4 4 4 4 4 4 4 3
3 2 2 2 2 2 2 2 2 4 4 4 4 4 4 4 4 4 4 4 4 4 4 4 4 4 4 4 4 4 4 4 4 4 4 4 4 4 4 4 4 4 4 4 4 4 4 4 4 4 4 4 4 4 4 4 4 4 4 4 4 4 4 4 4 4 4 4 4 4 4 4 4 4 4 4 4 4 4 4 4 4 4 4 4 4 4 4 4 4 4 4 4 4 4 4 4 4 4 3
3 2 2 2 2 2 2 2 2 2 4 4 4 4 4 4 4 4 4 4 4 4 4 4 4 4 4 4 4 4 4 4 4 4 4 4 4 4 4 4 4 4 4 4 4 4 4 4 4 4 4 4 4 4 4 4 4 4 4 4 4 4 4 4 4 4 4 4 4 4 4 4 4 4 4 4 4 4 4 4 4 4 4 4 4 4 4 4 4 4 4 4 4 4 4 4 4 4 4 3
3 2 2 2 2 2 2 2 2 2 2 4 4 4 4 4 4 4 4 4 5 5 5 5 4 4 5 5 5 5 5 5 5 5 5 5 5 5 5 5 5 5 5 5 5 5 5 5 5 5 5 5 5 5 5 5 5 5 5 5 5 5 5 5 5 5 5 5 5 5 5 5 6 6 6 6 6 6 6 6 5 5 5 5 5 5 4 4 4 4 4 4 4 4 4 4 4 4 4 3
3 2 2 2 2 2 2 2 2 2 2 2 4 4 4 4 4 4 4 4 5 5 5 5 4 4 5 5 5 5 5 5 5 5 5 5 5 5 5 5 5 5 5 5 5 5 5 5 5 5 5 5 5 5 5 5 5 5 5 5 5 5 5 5 5 5 5 5 5 5 5 5 6 6 6 6 6 6 6 6 5 5 5 5 5 5 4 4 4 4 4 4 4 4 4 4 4 4 4 3
3 2 2 2 2 2 2 2 2 2 2 2 2 4 4 4 4 4 4 4 5 5 5 5 4 4 5 5 5 5 5 5 5 5 5 5 5 5 5 5 5 5 5 5 5 6 6 6 6 6 6 6 6 6 6 5 5 5 5 5 5 5 5 5 5 5 5 5 5 5 5 5 5 5 5 5 5 5 5 5 5 5 5 5 5 5 4 4 4 4 4 4 4 4 4 4 4 4 4 3
3 2 2 2 2 2 2 2 2 2 2 2 2 2 4 4 4 4 4 4 5 5 5 5 4 4 5 5 5 5 5 5 5 5 5 5 5 5 5 5 5 5 5 5 5 6 6 6 6 6 6 6 6 6 6 5 5 5 5 5 5 5 5 5 5 5 4 4 4 4 5 5 5 5 5 5 5 5 5 5 5 5 5 5 5 5 4 4 4 4 4 4 4 4 4 4 4 4 4 3
3 2 2 2 2 2 2 2 2 2 2 2 2 2 2 4 4 4 4 4 5 5 5 5 4 4 5 5 5 5 5 5 5 5 5 5 5 5 5 5 5 5 5 5 5 6 6 6 6 6 6 6 6 6 6 5 5 5 5 5 5 5 5 4 4 4 4 4 4 4 4 5 5 5 5 5 5 5 5 5 5 5 7 7 7 7 4 4 4 4 4 4 4 4 4 4 4 4 4 3
3 2 2 2 2 2 2 2 2 2 2 2 2 2 2 2 4 4 4 4 5 5 5 5 4 4 5 5 5 5 5 5 5 5 5 5 5 5 5 5 5 5 5 5 5 6 6 6 6 6 6 6 6 6 6 5 5 5 5 4 4 4 4 4 4 4 4 4 4 4 4 4 5 5 5 5 5 5 5 5 5 5 7 7 7 7 4 4 4 4 4 4 4 4 4 4 4 4 4 3
3 2 2 2 2 2 2 2 2 2 2 2 2 2 2 2 2 4 4 4 5 5 5 5 4 4 5 5 5 5 5 5 5 5 5 5 5 5 5 5 5 5 5 5 5 6 6 6 6 6 6 6 6 6 6 5 4 4 4 4 4 4 4 4 4 4 4 4 4 4 4 4 4 5 5 5 5 5 5 5 5 5 7 7 7 7 4 4 4 4 4 4 4 4 4 4 4 4 4 3
3 2 2 2 2 2 2 2 2 2 2 2 2 2 2 2 2 2 4 4 5 5 5 5 4 4 5 5 5 5 5 5 5 5 5 5 5 5 5 5 5 5 5 5 5 6 6 6 6 6 6 6 4 4 4 4 4 4 4 4 4 4 4 4 4 5 5 5 5 4 4 4 4 4 5 5 5 5 5 5 5 5 5 5 5 5 4 4 4 4 4 4 4 4 4 4 4 4 4 3
3 2 2 2 2 2 2 2 2 2 2 2 2 2 2 2 2 2 2 4 5 5 5 5 4 4 5 5 5 5 5 5 5 5 5 5 5 5 5 5 5 5 5 5 5 6 6 6 6 4 4 4 4 4 4 4 4 4 4 4 4 5 5 5 5 5 5 5 5 5 4 4 4 4 4 5 5 5 5 5 5 5 5 5 5 5 4 4 4 4 4 4 4 4 4 4 4 4 4 3
3 2 2 2 2 2 2 2 2 2 2 2 2 2 2 2 2 2 2 2 5 5 5 5 4 4 5 5 5 5 5 5 5 5 5 5 5 5 5 5 5 5 5 5 5 6 6 4 4 4 4 4 4 4 4 4 4 4 5 5 5 5 5 5 5 5 5 5 5 5 5 4 4 4 4 4 5 5 5 5 5 5 5 5 5 5 4 4 4 4 4 4 4 4 4 4 4 4 4 3
3 0 0 0 0 0 0 0 0 0 0 1 1 1 0 0 0 0 0 0 5 5 5 5 4 4 5 5 5 5 5 5 7 7 7 7 7 7 7 7 7 7 5 5 5 6 2 4 4 4 4 4 4 4 6 5 5 5 5 5 5 5 5 5 5 5 5 5 5 5 5 5 4 4 4 4 4 5 5 5 5 5 5 5 5 5 4 4 4 4 4 4 4 4 4 4 4 4 A 3
3 0 0 0 0 0 0 0 0 0 0 1 1 1 0 0 0 0 0 0 5 5 5 5 4 4 5 5 5 5 5 5 7 7 7 7 7 7 7 7 7 7 5 5 2 2 2 4 4 4 4 6 6 6 6 5 5 5 5 5 5 5 5 5 5 5 5 5 5 5 5 5 7 7 7 7 4 4 5 5 5 5 5 5 5 5 4 4 4 4 4 4 4 4 4 4 4 A A 3
3 0 0 0 0 0 0 0 0 0 0 1 1 1 0 0 0 0 0 0 5 5 5 5 4 4 5 5 5 5 5 5 7 7 7 7 7 7 7 7 7 7 5 2 2 2 2 2 2 5 5 5 5 5 5 5 5 5 5 5 5 5 5 5 5 7 7 7 7 7 7 7 5 5 4 4 4 4 4 5 5 5 5 5 5 5 4 4 4 4 4 4 4 4 4 4 A A A 3
3 0 0 0 0 0 0 0 0 0 0 1 1 1 0 0 0 0 0 0 5 5 5 5 4 4 5 5 5 5 5 5 7 7 7 7 7 7 7 7 7 7 2 2 2 2 2 2 5 5 5 5 5 5 5 5 5 5 7 7 7 7 7 7 7 5 5 5 5 5 5 5 5 5 5 4 4 4 4 4 5 5 5 5 5 5 4 4 4 4 4 4 4 4 4 A A A A 3
3 0 0 0 0 0 0 0 0 0 0 1 1 1 0 0 0 0 0 0 5 5 5 5 4 4 5 5 5 5 5 5 7 7 7 7 7 7 7 7 2 2 2 2 2 2 5 5 5 5 7 7 7 7 7 7 7 7 5 5 5 5 5 5 5 5 5 5 5 5 5 5 5 5 5 5 4 4 4 4 5 5 5 5 5 5 4 4 4 4 4 4 4 4 A A A A A 3
3 0 0 0 0 0 0 0 0 0 1 1 1 1 0 0 0 0 0 0 5 5 5 5 4 4 5 5 5 5 5 5 5 5 5 5 5 5 5 2 2 2 2 7 7 7 7 7 7 7 5 5 5 5 5 5 5 5 5 5 5 5 5 5 5 5 5 5 5 5 5 5 5 5 5 5 5 4 4 4 5 5 5 5 5 5 4 4 4 4 4 4 4 A A A A A A 3
3 0 0 0 0 0 0 0 0 1 1 1 1 1 0 0 0 0 0 0 5 5 5 5 4 4 5 5 5 5 5 5 5 5 5 5 7 7 7 7 7 7 7 2 5 5 5 5 5 5 5 5 5 5 5 5 5 5 5 5 5 5 5 5 5 5 5 5 5 5 5 5 5 5 5 5 5 4 4 4 5 5 5 5 5 5 4 4 4 4 4 4 A A A A A A A 3
3 0 0 0 0 0 0 0 1 1 1 1 1 1 0 0 0 0 0 0 5 5 5 5 4 4 5 5 5 5 5 5 3 3 3 3 2 2 2 2 2 2 5 5 5 5 5 5 5 5 5 5 5 5 5 5 5 5 5 5 5 5 5 5 5 5 5 5 5 5 5 5 5 5 5 5 5 4 7 7 7 7 5 5 5 5 4 4 4 4 4 A A A A A A A A 3
3 0 0 0 0 0 0 0 0 1 1 1 1 1 0 0 0 0 0 0 5 5 5 5 4 4 5 5 5 5 5 5 5 5 5 2 2 2 2 2 2 5 5 5 5 5 5 5 5 5 5 5 5 5 5 5 5 5 5 5 5 5 5 5 5 5 5 5 5 5 5 7 7 7 7 7 7 7 4 4 4 5 5 5 5 5 4 4 4 4 A A A A A A A A A 3
3 0 0 0 0 0 0 0 0 0 1 1 1 1 0 0 0 0 0 0 5 5 5 5 4 4 5 5 5 5 5 5 5 2 2 2 2 2 2 2 5 5 5 5 5 5 5 5 5 5 5 5 5 5 5 5 5 5 5 5 5 5 5 5 7 7 7 7 7 7 7 5 5 5 5 5 5 5 4 4 4 5 5 5 5 5 4 4 4 A A A A A A A A A A 3
3 0 0 0 0 0 0 0 0 0 0 1 1 1 0 0 0 0 0 0 5 5 5 5 4 4 5 5 5 5 5 2 2 2 2 2 2 2 5 5 5 5 5 5 5 5 5 5 5 5 5 5 5 5 5 5 7 7 7 7 7 7 7 7 5 5 5 5 5 5 5 5 5 5 5 5 5 5 4 4 4 5 5 5 5 5 4 4 A A A A A A A A A A A 3
3 0 0 0 0 0 0 0 0 0 0 1 1 1 0 0 0 0 0 0 5 5 5 5 4 4 5 5 5 3 2 2 2 2 2 2 2 5 5 5 5 5 5 5 5 5 5 5 5 7 7 7 7 7 7 7 5 5 5 5 5 5 5 5 5 5 5 5 5 5 5 5 5 5 5 5 5 5 4 4 4 5 5 5 5 5 4 A A A A A A A A A A A A 3
3 0 0 0 0 0 0 0 0 0 0 1 1 1 0 0 0 0 0 0 5 5 5 5 4 4 5 2 2 3 2 2 2 2 2 5 5 5 5 5 5 5 7 7 7 7 7 7 7 5 5 5 5 5 5 5 5 5 5 5 5 5 5 5 5 5 5 5 5 5 5 5 5 5 5 A A A 4 4 4 4 A A A A A A A A A A A A A A A A A 3
3 0 0 0 0 0 0 0 0 0 0 1 1 1 0 0 0 0 0 0 0 0 0 0 0 2 2 2 2 3 2 2 2 2 2 2 2 4 4 4 4 4 4 4 4 4 4 4 4 4 4 4 4 4 4 4 4 4 4 4 4 4 4 4 4 4 4 4 4 4 4 4 4 4 4 A A A 4 4 4 4 A B A A A A A A A A A A A A A A A 3
3 0 0 0 0 0 0 0 0 0 0 1 1 1 0 0 0 0 0 0 0 0 0 0 0 2 2 2 2 3 2 0 2 2 2 2 2 2 4 4 4 4 4 4 4 4 4 4 4 4 4 4 4 4 4 4 4 4 4 4 4 4 4 4 4 4 4 4 4 4 4 4 4 4 A A A A A 4 4 4 A B A A A A A A A A A A A A A A A 3
3 0 0 0 0 0 0 0 0 0 0 1 1 1 0 0 0 0 0 0 0 0 0 0 2 2 2 2 2 3 0 0 2 2 2 2 2 2 2 4 4 4 4 4 4 4 4 4 4 4 4 4 4 4 4 4 4 4 4 4 4 4 4 4 4 4 4 4 4 4 4 4 4 A A A A A A A A A A B A A A A A A A A A A A A A A A 3
3 0 0 0 0 0 0 0 0 0 0 1 1 1 0 0 0 0 0 0 0 0 0 0 2 2 2 2 0 3 0 0 2 2 2 2 2 2 2 2 4 4 4 4 4 4 4 4 4 4 4 4 4 4 4 4 4 4 4 4 4 4 4 4 4 4 4 4 4 4 4 4 A A A A A A A A A A A B A A A A A A A A A A A A A A A 3
3 0 0 0 0 0 0 0 0 0 0 1 1 1 0 0 0 0 0 0 0 0 0 3 2 2 2 0 0 0 3 0 2 2 2 2 2 2 2 2 2 4 4 4 4 4 4 4 4 4 4 4 4 4 4 4 4 4 4 4 4 4 4 4 4 4 4 4 4 4 4 A A A A A A A A A A A A A B A A A A A A A A A A A A A A 3
3 0 0 0 3 0 3 0 3 0 3 1 1 1 3 0 3 0 3 0 3 0 0 3 2 2 2 0 0 0 3 0 2 2 2 2 2 2 2 2 2 2 4 4 4 4 4 4 4 4 4 4 4 4 4 4 4 4 4 4 4 4 4 4 4 4 4 4 4 4 A A A A A A A A A A A A A A B A A A A A A A A A A A A A A 3
3 0 0 0 0 3 0 3 0 3 0 1 1 1 0 3 0 3 0 3 0 0 2 3 2 2 0 0 0 0 3 0 2 2 2 2 2 2 2 2 2 2 2 4 4 4 4 4 4 4 4 4 4 4 4 4 4 4 4 4 4 4 4 4 4 4 4 4 4 A A A A A A A A B A A A A A A B A A A A A A A A A A A A A A 3
3 0 0 0 3 0 1 1 1 1 1 1 1 1 1 1 1 1 1 0 3 0 2 3 2 2 0 0 0 0 3 0 2 2 2 2 2 2 2 2 2 2 2 2 4 4 4 4 4 4 4 4 4 4 4 4 4 4 4 4 4 4 4 4 4 4 4 4 A A A A A A A A A B A A A A A A B A A A A A A A A A A A A A A 3
3 0 0 0 0 1 1 1 1 1 1 1 1 1 1 1 1 1 1 3 0 2 2 3 2 0 0 0 0 0 3 0 2 2 2 2 2 2 2 2 2 2 2 2 2 4 4 4 4 4 4 4 4 4 4 4 4 4 4 4 4 4 4 4 4 4 4 A A A A A A A A A A B A A A A A A B A A A A A A A A A A A A A A 3
3 0 0 0 3 1 1 1 1 1 1 1 1 1 1 1 1 1 1 0 3 2 2 3 2 0 0 0 0 0 3 0 2 2 2 2 2 2 2 2 2 2 2 2 2 2 4 4 4 4 4 4 4 4 4 4 4 4 4 4 4 4 4 4 4 4 A A A A A A A A A A A B A A A A A A A B A A A A A A A A A A A A A 3
3 0 0 0 0 1 1 0 0 0 1 1 1 1 1 1 1 1 1 3 2 2 2 2 3 0 0 0 0 0 3 0 2 2 2 2 2 2 2 2 2 2 2 2 2 2 2 4 4 4 4 4 4 4 4 4 4 4 4 4 4 4 4 4 4 A A A A A A A A A A A A A B A 9 A A A A B A A A A A A A A A A A A A 3
3 0 0 0 3 1 1 0 0 0 1 1 1 1 1 1 1 1 1 0 2 2 2 2 3 0 0 0 0 0 3 0 2 2 2 2 2 2 2 2 2 2 2 2 2 2 2 2 4 4 4 4 4 4 4 4 4 4 4 4 4 4 4 4 A A A A A A A A A A A A A A B B 9 A A A A B A A A A A A A A A A A A A 3
3 0 0 0 0 1 1 0 0 0 1 1 1 1 1 1 1 1 1 2 2 2 2 0 3 0 0 0 0 0 3 0 2 2 2 2 2 2 2 2 2 2 2 2 2 2 2 2 2 4 4 4 4 4 4 4 4 4 4 4 4 4 4 A A A A A A A A A A A A A A A B A 9 A A A A B A A A A A A A A A A A A A 3
3 0 0 0 3 1 1 1 1 1 1 1 1 1 1 1 1 1 1 2 2 2 2 0 3 0 0 0 0 0 3 0 2 2 2 2 2 2 2 2 2 2 2 2 2 2 2 2 2 2 4 4 4 4 4 4 4 4 4 4 4 4 A A A A A A A A A A A A A A A A B A 9 A A A A B A A A A A A A A A A A A A 3
3 0 0 0 0 1 1 1 1 3 3 3 1 1 1 1 1 1 1 2 2 2 2 0 3 0 0 0 0 0 3 0 2 2 2 2 2 2 2 2 2 2 2 2 2 2 2 2 2 2 2 4 4 4 4 4 4 4 4 4 4 A A A A A A A A A A A A A A A A A B A 9 A A A A B A A A A A A A A A A A A A 3
3 0 0 0 3 1 1 1 1 3 3 3 1 1 1 1 3 3 3 2 2 2 2 2 3 0 0 0 0 0 3 0 2 2 2 2 2 2 2 2 2 2 2 2 2 2 2 2 2 2 2 2 4 4 4 4 4 4 4 4 A A A A A A A A A A A A A A A A A A A B 9 A A A A B A A A A A 8 A 8 A A A A A 3
3 0 0 0 0 1 1 1 1 3 3 3 1 1 1 1 3 3 3 1 2 2 2 2 3 0 0 0 0 0 0 3 2 2 2 2 2 2 2 2 2 2 2 2 2 2 2 2 2 2 2 2 2 4 4 4 4 4 4 A A A A A A A A A A A A A A A A A A A A B 9 A A A A A B A A 8 A A 9 A A 8 A A A 3
3 0 0 0 3 1 1 1 1 1 1 1 1 1 1 1 3 3 3 1 1 2 2 2 3 0 0 0 0 0 0 3 2 2 2 2 2 2 2 2 2 2 2 2 2 2 2 2 2 2 2 2 2 2 4 4 4 4 A A A A A A A A A A A A A A A A A A A A A B 9 A A A A A B A A A 9 9 9 9 9 A A A A 3
3 0 0 0 0 1 1 1 1 1 1 1 1 1 1 1 1 1 1 1 1 2 2 2 3 2 0 0 0 0 0 3 2 2 2 2 2 2 2 2 2 2 2 2 2 2 2 2 2 2 2 2 2 2 2 4 4 A A A A A A A A A A A A A A A A A A A A A A B 9 A A A A A B A 8 A 9 9 9 9 9 A 8 A A 3
3 0 0 0 3 1 1 1 1 1 1 1 1 1 1 1 1 1 1 1 1 1 2 2 3 2 2 0 0 0 0 3 2 2 2 2 2 2 2 2 2 2 2 2 2 2 2 2 2 2 2 2 2 2 2 2 A A A A A A A A A A A A A A A A A A A A A A A B 9 A A A A A B A A 9 9 9 9 9 9 9 A A A 3
3 0 0 0 0 1 1 1 1 1 1 1 1 1 1 1 1 1 1 1 1 1 0 2 3 2 2 2 0 0 0 3 2 2 2 2 2 2 2 2 2 2 2 2 2 2 2 2 2 2 2 2 2 2 2 2 A A A A A A A A A A A A A A A A A A A A A A A B 9 A A A A A B A 8 A 9 9 9 9 9 A 8 A A 3
3 0 0 0 3 1 1 1 1 1 1 1 1 1 1 1 1 1 1 1 1 1 0 0 3 2 2 2 0 0 0 3 2 2 2 2 2 2 2 2 2 2 2 2 2 2 2 2 2 2 2 2 2 2 2 2 A A A A A A A A A A A A A A A A A A A A A A A B 9 A A A A A A B A A 9 9 9 9 9 A A A A 3
3 0 0 0 0 1 1 1 0 3 0 1 1 1 0 3 0 3 0 1 1 1 0 0 0 3 2 2 2 0 0 0 2 2 2 2 2 2 2 2 2 2 2 2 2 2 2 2 2 2 2 2 2 2 2 2 A A A A A A A A A A A A A A A A A A A A A A A A B A A A A A A B A 8 A A 9 A A 8 A A A 3
3 0 0 0 3 1 1 1 0 0 0 1 1 1 3 0 0 0 0 1 1 1 1 0 0 3 2 2 2 2 0 0 2 2 2 2 2 2 2 2 2 2 2 2 2 2 2 2 2 2 2 2 2 2 2 2 A A A A A A A A A A A A A A A A A A A A A A A B B A A A A A A B A A A 8 A 8 A A A A A 3
3 0 0 0 0 1 1 1 0 0 0 1 1 1 1 1 0 0 0 1 1 1 1 1 1 3 2 2 2 2 C C 2 2 2 2 2 2 2 2 C C C C C C C C C C C C C C C C C C C C C C C C C C C C C C C C C C C C C C C C B C C C A A A B A A A A A A A A A A A 3
3 0 0 0 0 1 1 1 0 0 0 1 1 1 1 1 0 0 0 1 1 1 1 1 1 3 1 2 2 2 C C C 2 2 2 2 2 2 2 C C C C C C C C C C C C C C C C C C C C C C C C C C C C C C C C C C C C C C C C B C C C A A A B A A A A A A A A A A A 3
3 0 0 0 0 1 1 1 1 1 1 1 1 1 1 1 1 1 1 1 1 1 1 1 1 3 1 1 C C C C C C C 2 2 2 2 2 C C C C C C C C C C C C C C C C C C C C C C C C C C C C C C C C C C C C C C C C B C C C A A A B A A A A A A A A A A A 3
3 0 0 0 0 0 0 0 0 0 0 1 1 1 0 0 0 0 0 0 1 1 1 0 0 3 0 0 0 0 C C C C C C C 2 2 2 C C C C C C C C C C C C C C C C C C C C C C C C C C C C C C C C C C C C C C C C C B C C C A A B A A A A A A A A A A A 3
3 0 0 0 0 0 0 0 0 0 0 1 1 1 0 0 0 0 0 0 0 1 1 0 0 0 0 3 0 0 0 C C C C C C C 2 2 C C C C C C C C C C C C C C C C C C C C C C C C C C C C C C C C C C C C C C C C C B C C C A A A B A A B A A A B A A A 3
3 0 0 0 0 0 0 0 0 0 0 1 1 1 0 0 0 0 0 3 1 1 1 0 0 0 1 1 1 3 0 0 2 C C C C C C C C C C C C C C C C C C C C C C C C C C C C C C C C C C C C C C C C C C C C C C C C B D D C A A A B 9 9 9 9 9 9 9 9 A A 3
3 0 0 0 0 0 0 0 0 0 0 1 1 1 0 0 0 0 0 0 1 1 1 1 1 1 1 1 1 0 0 0 2 2 2 C C C C C C C C C C C C C C C C C C C C C C C C C C C C C C C C C C C C C C C C C C C C C C B C C C A A A B A A A A A A A A A A 3
3 0 0 0 0 0 0 0 0 0 0 1 1 1 0 0 0 0 0 0 1 1 1 1 1 1 1 1 1 0 0 0 2 2 2 2 C C C C C C C C C C C C C C C C C C C C C C C C C C C C C C C C C C C C C C C C C C C C C B C C C A A A B A A A A A A A A A A 3
3 0 0 0 0 0 0 0 0 0 0 1 1 1 0 0 0 0 0 3 1 3 3 3 1 1 1 1 1 3 0 0 2 2 2 2 2 2 C C C C C C C C C C C C C C C C C C C C C C C C C C C C C C C C C C C C C C C C C C C B C C C A A A B A A A A A A A A A A 3
3 0 0 0 0 0 0 0 0 0 0 1 1 1 0 0 0 0 0 0 1 3 3 3 1 1 1 1 1 0 0 0 2 2 2 2 2 2 2 2 C C C C C C C C C C C C C C C C C C C C C C C C C C C C C C C C C C C C C C C C C B C C C A A A A B A A A A A A A A A 3
3 0 0 0 0 0 0 0 0 0 0 1 1 1 0 0 0 0 0 0 1 3 3 3 1 1 1 1 1 0 0 0 2 2 2 2 2 2 2 2 C C C C C C C C C C C C C C C C C C C C C C C C C C C C C C C C C C C C C C C C C C B C C A A A A B A A A A A A A A A 3
3 0 0 0 0 0 0 0 0 0 0 1 1 1 0 0 0 0 0 3 1 1 1 1 1 1 1 1 1 3 0 0 2 2 2 2 2 2 2 2 C C C C C C C C C C C C C C C C C C C C C C C C C C C C C C C C C C C C C C C C C C B C C A A A A B A A A A A A A A A 3
3 0 0 0 0 0 0 0 0 0 0 1 1 1 0 0 0 0 0 0 1 1 1 1 1 1 1 1 1 0 0 0 2 2 2 2 2 2 2 2 C C C C C C C C C C C C C C C C C C C C C C C C C C C C C C C C C C C C C C C C C C B C C A A A A B A A A A A A A A A 3
3 0 0 0 0 0 0 0 0 0 0 0 0 1 0 0 0 0 0 0 1 1 1 1 1 1 1 1 1 0 0 0 2 2 2 2 2 2 2 2 C C C C C C C C C C C C C C C C C C C C C C C C C C C C C C C C C C C C C C C C C C B C C A A A A A A A A A A A A A A 3
3 0 0 0 0 0 0 0 0 0 0 0 0 1 0 0 0 0 0 3 1 1 1 1 1 1 1 1 1 3 0 0 2 2 2 2 2 2 2 2 C C C C C C C C C C C C C C C C C C C C C C C C C C C C C C C C C C C C C C C C C C B C C A A A A A A A A A A A A A A 3
3 0 0 0 0 0 0 0 1 0 0 0 0 1 0 0 0 0 0 0 1 1 1 1 1 1 1 1 1 0 0 0 2 2 2 2 2 2 2 2 C C C C C C C C C C C C C C C C C C C C C C C C C C C C C C C C C C C C C C C C C C C B C A A A A A A A A A A A A A A 3
3 0 0 0 0 0 1 1 1 1 1 1 1 1 0 0 0 0 0 0 0 3 0 0 3 0 0 3 0 0 0 0 2 2 2 2 2 2 2 2 C C C C C C C C C C C C C C C C C C C C C C C C C C C C C C C C C C C C C C C C C C C B C A A A A A A A A A A A A A A 3
3 0 0 0 0 1 1 1 1 1 1 1 1 1 0 0 0 0 0 0 0 0 0 0 0 0 0 0 0 0 0 0 2 2 2 2 2 2 2 2 C C C C C C C C C C C C C C C C C C C C C C C C C C C C C C C C C C C C C C C C C C C B C C A A A A A A A A A A A A A 3
3 0 0 0 0 0 1 1 1 1 1 1 1 1 0 0 0 0 0 0 0 0 0 0 0 0 0 0 0 0 0 0 2 2 2 2 2 2 2 2 C C C C C C C C C C C C C C C C C C C C C C C C C C C C C C C C C C C C C C C C C C C B C C A A A A A A A A A A A A A 3
3 0 0 0 0 0 0 0 1 0 0 1 1 1 0 0 0 0 0 0 0 0 0 0 0 0 0 0 0 0 0 0 2 2 2 2 2 2 2 2 C C C C C C C C C C C C C C C C C C C C F G H C C C C C C C C C C C C C C C C C C C C C C C A A A A A A A A A A A A A 3
3 0 0 0 0 0 0 0 0 0 0 1 1 1 0 0 0 0 0 0 0 0 0 0 0 0 0 0 0 0 0 0 2 2 2 2 2 2 2 2 C C C C C C C C C C C C C C C C C C C C I J I C C C C C C C C C C C C C C C C C C C C C C C A A A A A A A A A A A A A 3
3 0 0 0 0 0 0 0 0 0 0 1 1 1 0 0 0 0 0 0 0 0 0 0 0 0 0 0 0 0 0 0 2 2 2 2 2 2 2 2 C C C C C C C C C C C C C C C C C C C C I K I C C C C C C C C C C C C C C C C C C C C C C C A A A A A A A A A A A A A 3
3 0 0 0 0 0 0 0 0 0 0 1 1 1 0 0 0 0 0 0 0 0 0 0 0 0 0 0 0 0 0 0 2 2 2 2 2 2 2 2 C C C C C C C C C C C C C C C C C C C C C C C C C C C C C C C C C C C C C C C C C C C C C C A A A A A A A A A A A A A 3
3 0 0 0 0 0 0 0 0 0 0 1 1 1 0 0 0 0 0 0 0 0 0 0 0 0 0 0 0 0 0 0 2 2 2 2 2 2 2 2 C C C C C C C C C C C C C C C C C C C C C C C C C C C C C C C C C C C C C C C C C C C C C C 9 A A A A A A A A A A A A 3
3 0 0 0 0 0 0 0 0 0 0 1 1 1 0 0 0 0 0 0 0 0 0 0 0 0 0 0 0 0 0 0 2 2 2 2 2 2 2 2 C C C C C C C C C C C C C C C C C C C C C C C C C C C C C C C C C C C C C C C C C C C C C C A A A A A A A A A A A A A 3
3 0 0 0 0 0 0 0 0 0 0 1 1 1 0 0 0 0 0 0 0 0 0 0 0 0 0 0 0 0 0 0 2 2 2 2 2 2 2 2 C C C C C C C C C C C C C C C C C C C C C C C C C C C C C C C C C C C C C C C C C C C C C C A A A A A A A A A A A A A 3
3 0 0 0 0 0 0 0 0 0 0 1 1 1 0 0 0 0 0 0 0 0 0 0 0 0 0 0 0 0 0 0 2 2 2 2 2 2 2 2 C C C C C C C C C C C C C C C C C C C C C C C C C C C C C C C C C C C C C C C C C C C C C C A A A A A A A A A A A A A 3
3 0 0 0 0 0 0 0 0 0 0 1 1 1 0 0 0 0 0 0 0 0 0 0 0 0 0 0 0 0 0 0 2 2 2 2 2 2 2 2 C C C C C C C C C C C C C C C C C C C C C C C C C C C C C C C C C C C C C C C C C C C C C C A A A A A A A A A A A A A 3
3 2 2 2 2 2 2 2 2 2 2 2 2 2 2 2 2 2 2 2 2 2 2 2 2 2 2 2 2 2 2 2 2 2 2 2 2 2 2 2 C C C C C C C C C C C C C C C C C C C C C C C C C C C C C C C C C C C C C C C C C C C C C C A A A A A A A A A A A A A 3
3 2 2 2 2 2 2 2 2 2 2 2 2 2 2 2 2 2 2 2 2 2 2 2 2 2 2 2 2 2 2 2 2 2 2 2 2 2 2 2 C C C C C C C C C C C C C C C C C C C C C C C C C C C C C C C C C C C C C C C C C C C C C C A A A A A A A A A A A A A 3
3 2 2 2 2 2 2 2 2 2 2 2 2 2 2 2 2 2 2 2 2 2 2 2 2 2 2 2 2 2 2 2 2 2 2 2 2 2 2 2 C C C C C C C C C C C C C C C C C C C C C C C C C C C C C C C C C C C C C C C C C C C C C C A A A A A A A A A A A A A 3
3 2 2 2 2 2 2 2 2 2 2 2 2 2 2 2 2 2 2 2 2 2 2 2 2 2 2 2 2 2 2 2 2 2 2 2 2 2 2 2 C C C C C C C C C C C C C C C C C C C C C C C C C C C C C C C C C C C C C C C C C C C C C C A A A A A A A A A A A A A 3
3 2 2 2 2 2 2 2 2 2 2 2 2 2 2 2 2 2 2 2 2 2 2 2 2 2 2 2 2 2 2 2 2 2 2 2 2 2 2 2 C C C C C C C C C C C C C C C C C C C C C C C C C C C C C C C C C C C C C C C C C C C C C C A A A A A A A A A A A A A 3
3 2 2 2 2 2 2 2 2 2 2 2 2 2 2 2 2 2 2 2 2 2 2 2 2 2 2 2 2 2 2 2 2 2 2 2 2 2 2 2 C C C C C C C C C C C C C C C C C C C C C C C C C C C C C C D D D C C C C C C C C C C C C C A A A A A A A A A A A A A 3
3 2 2 2 2 2 2 2 2 2 2 2 2 2 2 2 2 2 2 2 2 2 2 2 2 2 2 2 2 2 2 2 2 2 2 2 2 2 2 2 C C C C C C C C C C C C C C C C C C C C C C C C C C C C C C C C C C C C C C C C C C C C C C A A A A A A A A A A A A A 3
3 2 2 2 2 2 2 2 2 2 2 2 2 2 2 2 2 2 2 2 2 2 2 2 2 2 2 2 2 2 2 2 2 2 2 2 2 2 2 2 C C C C E E E C C C C C C C C C C C C C C C C C C C C C C C C C C C C C C C C C C C C C C C A A A A A A A A A A A A A 3
3 2 2 2 2 2 2 2 2 2 2 2 2 2 2 2 2 2 2 2 2 2 2 2 2 2 2 2 2 2 2 2 2 2 2 2 2 2 2 2 C C C C E E E C C C C C C C C C C C C C C C C C C C C C C C C C C C C C C C C C C C C C C C A A A A A A A A A A A A A 3
3 2 2 2 2 2 2 2 2 2 2 2 2 2 2 2 2 2 2 2 2 2 2 2 2 2 2 2 2 2 2 2 2 2 2 2 2 2 2 2 C C C C C C C C C C C C C C C C C C C C C C C C C C C C C C C C C C C C E E C C C C C C C C A A A A A A A A A A A A A 3
3 2 2 2 2 2 2 2 2 2 2 2 2 2 2 2 2 2 2 2 2 2 2 2 2 2 2 2 2 2 2 2 2 2 2 2 2 2 2 2 C C C C C C C C C C C C C C C C C C C C C C C C C C C C C C C C C C C C C C C C C C C C C C A A A A A A A A A A A A A 3
3 2 2 2 2 2 2 2 2 2 2 2 2 2 2 2 2 2 2 2 2 2 2 2 2 2 2 2 2 2 2 2 2 2 2 2 2 2 2 2 C C C C C C C C C C C C C C C C C C C C C C C C C C C C C C C C C C C C C C C C C C C C C C A A A A A A A A A A A A A 3
3 2 2 2 2 2 2 2 2 2 2 2 2 2 2 2 2 2 2 2 2 2 2 2 2 2 2 2 2 2 2 2 2 2 2 2 2 2 2 2 C C C C C C C C C C C C C C C C C C C C C C C C C C C C C C C C C C C C C C C C C C C C C C A A A A A A A A A A A A A 3
3 2 2 2 2 2 2 2 2 2 2 2 2 2 2 2 2 2 2 2 2 2 2 2 2 2 2 2 2 2 2 2 2 2 2 2 2 2 2 2 2 2 2 2 2 2 2 2 2 2 2 2 A A A A A A A A A A A A A A A A A A A A A A A A A A A A A A A A A A A A A A A A A A A A A A A 3
3 2 2 2 2 2 2 2 2 2 2 2 2 2 2 2 2 2 2 2 2 2 2 2 2 2 2 2 2 2 2 2 2 2 2 2 2 2 2 2 2 2 2 2 2 2 2 2 2 2 2 2 A A A A A A A A A A A A A A A A A A A A A A A A A A A A A A A A A A A A A A A A A A A A A A A 3
3 2 2 2 2 2 2 2 2 2 2 2 2 2 2 2 2 2 2 2 2 2 2 2 2 2 2 2 2 2 2 2 2 2 2 2 2 2 2 2 2 2 2 2 2 2 2 2 2 2 2 2 A A A A A A A A A A A A A A A A A A A A A A A A A A A A A A A A A A A A A A A A A A A A A A A 3
3 3 3 3 3 3 3 3 3 3 3 3 3 3 3 3 3 3 3 3 3 3 3 3 3 3 3 3 3 3 3 3 3 3 3 3 3 3 3 3 3 3 3 3 3 3 3 3 3 3 3 3 3 3 3 3 3 3 3 3 3 3 3 3 3 3 3 3 3 3 3 3 3 3 3 3 3 3 3 3 3 3 3 3 3 3 3 3 3 3 3 3 3 3 3 3 3 3 3 3
R 56 17 1 1
R 29 10 1 1
R 72 4 1 1
R 64 10 1 1
R 58 5 1 1
R 19 50 2 1
R 3 74 2 1
R 13 44 2 1
R 14 55 2 1
R 5 80 2 1
R 53 90 3 1
R 44 81 3 1
R 61 96 3 1
R 46 92 3 1
R 52 81 3 1
R 75 66 0 0
